@Christianus|Chrīstiānus, -a, -um, adj., Christian (25) LL-PAIDEIA
@Curia|Cūria, -ae, f., senate, meeting house (19) LL-PAIDEIA
@Lar|Lār, Laris, m., Lares (usually pl.), tutelary gods of the home and hearth (23) LL-PAIDEIA
@Pantheum|Pantheum, -ī, n., Pantheon (11) LL-PAIDEIA
@Papa|Pāpa, -ae, m., the Pope (19) LL-PAIDEIA
@Russicus|Russicus, -a, -um, adj., Russian (29) LL-PAIDEIA
@Sina|Sīna, -ae, f., China (7) LL-PAIDEIA
@Sinensis|Sīnēnsis, Sīnēnse, adj., Chinese (7) LL-PAIDEIA
@Spartanus|Spartānus, -a, -um, adj., Spartan (27) LL-PAIDEIA
@Vesta|Vesta, -ae, f., goddess of the hearth and the household (17) LL-PAIDEIA
@Vestalis|Vestālis, Vestāle, adj., Vestal, of Vesta (19) LL-PAIDEIA
ab|ab, ā, prep. with abl., by, from (11) LL-PAIDEIA
abeo|abeō, abīre, abīvī, abitus, depart, go away (14) LL-PAIDEIA
abeo|abeō, abīre, abīvī, abitus, depart, go away (14) LL-PAIDEIA
abhinc|abhinc, adv., ago, from this place (25) LL-PAIDEIA
absum|absum, abesse, āfuī, āfutūrus, be away, be absent (11) LL-PAIDEIA
abutor|abūtor, abūti, abūsus sum, abuse, use up (10) LL-PAIDEIA
ac|ac, conj., and (14) LL-PAIDEIA
accedo|accēdō, accēdere, accessī, accessus, come near, approach (29) LL-PAIDEIA
accido|accidō, accidere, accidī, —,  happen (23) LL-PAIDEIA
accipio|accipiō, accipere, accēpī, acceptus, take, receive, let in (13) LL-PAIDEIA
accurate|accūrātē, adv., carefully (27) LL-PAIDEIA
accusativus|accūsātīvus, -a, -um, adj., accusative (case) (22) LL-PAIDEIA
acerbus|acerbus, -a, -um adj., bitter (15) LL-PAIDEIA
acervus|acervus, -ī, m., pile (27) LL-PAIDEIA
ad|ad, prep. with acc., to, up to, towards (10) LL-PAIDEIA
adeo|adeō, adīre, adīvī/adiī, aditus, approach, visit (14) LL-PAIDEIA
adhuc|adhūc, adv., still (13) LL-PAIDEIA
adiungo|adiungō, adiungere, adiūnxī, adiūnctus, add, attach, join to (25) LL-PAIDEIA
adjungo|adiungō, adiungere, adiūnxī, adiūnctus, add, attach, join to (25) LL-PAIDEIA
adiuvo|adiuvō, adiuvāre, adiūvī, adiūtus, help (16) LL-PAIDEIA
adjuvo|adiuvō, adiuvāre, adiūvī, adiūtus, help (16) LL-PAIDEIA
adloquor|adloquor, adloquī, adlocūtus sum, speak to (18) LL-PAIDEIA
administro|administrō, administrāre, administrāvī, administrātus, manage (19) LL-PAIDEIA
admiratio|admīrātiō, admīrātiōnis, f., wonder, surprise (26) LL-PAIDEIA
admiror|admīror, admīrārī, admīrātus sum, admire, wonder at (26) LL-PAIDEIA
adoro|adōrō, adōrāre, adōrāvī, adōrātus, honor, adore, worship (26) LL-PAIDEIA
adsum|adsum, adesse, adfuī, adfutūrus, be present (14) LL-PAIDEIA
advenio|adveniō, advenīre, advēnī, adventus, come to, arrive (16) LL-PAIDEIA
aedificatus|aedificātus, -a, -um, adj., built, constructed, made (26) LL-PAIDEIA
aedificium|aedificium, -iī, n., building (16) LL-PAIDEIA
aedifico|aedificō, aedificāre, aedificāvī, aedificātus, build, construct, make, create (24) LL-PAIDEIA
aeger|aeger, aegra, aegrum, adj., sick (16) LL-PAIDEIA
aegrotus|aegrōtus, -a, -um, adj., sick (15) LL-PAIDEIA
aer|āēr, āeris, m., air, atmosphere (17) LL-PAIDEIA
aestas|aestās, aestātis, f., summer (28) LL-PAIDEIA
aestimo|aestimō, aestimāre, aestimāvī, aestimātus, consider, judge (16) LL-PAIDEIA
aestivus|aestīvus, -a, -um, adj., pertaining to summer (28) LL-PAIDEIA
aetas|aetās, aetātis, f., period, age, era (22) LL-PAIDEIA
aeternus|aeternus,  -a, -um, adj., eternal, everlasting (24) LL-PAIDEIA
affero|afferō, afferre, attulī, allātus, bring, carry (29) LL-PAIDEIA
ager|ager, agrī, m., field (19) LL-PAIDEIA
ago|agō, agere, ēgī, āctus, act, thank (with grātiās) (7) LL-PAIDEIA
agricola|agricola, agricolae, m., farmer (19) LL-PAIDEIA
ait|ait, —, —,  say (27) LL-PAIDEIA
ala|āla, -ae, f., wing (27) LL-PAIDEIA
albus|albus, -a, -um, adj., white (13) LL-PAIDEIA
ales|āles, ālitis, m./f., bird (18) LL-PAIDEIA
alibi|alibī, adv., elsewhere, in another place (23) LL-PAIDEIA
alienus|aliēnus, -a, -um, adj., foreign, unfamiliar (11) LL-PAIDEIA
aliqua|aliquā, adv., somehow (24) LL-PAIDEIA
aliquando|aliquandō, adv., sometime (9) LL-PAIDEIA
aliquis|aliquis, aliquid, someone, something, anyone (15) LL-PAIDEIA
aliter|aliter, adv., otherwise, differently (23) LL-PAIDEIA
alius|alius, alia, aliud, adj., other (5) LL-PAIDEIA
alloquor|alloquor, alloquī, allocūtus sum, speak, make a speech (30) LL-PAIDEIA
almus|almus, -a, -um, adj., nourishing, kind (15) LL-PAIDEIA
alo|alō, alere, aluī, altus, feed, support (23) LL-PAIDEIA
alter|alter, altera, alterum, adj., other, another (12) LL-PAIDEIA
altitudo|altitūdō, altitūdinis, f., height, altitude (24) LL-PAIDEIA
altus|altus, -a, -um, adj., high, tall (14) LL-PAIDEIA
alvus|alvus, -ī, f., belly, womb, cavity (23) LL-PAIDEIA
amabilis|amābilis, amābile, adj., lovable, pleasant, delightful (29) LL-PAIDEIA
amasia|amāsia, -ae, f., girlfriend (25) LL-PAIDEIA
amator|amātor, amātōris, m., lover (13) LL-PAIDEIA
ambo|ambō, both (16) LL-PAIDEIA
amb|ambō, both (16) LL-PAIDEIA
ambulo|ambulō, ambulāre, ambulāvī, ambulātus, walk (5) LL-PAIDEIA
amens|āmēns, āmentis, adj., insane, out of one's mind (29) LL-PAIDEIA
amicus|amīcus, amīcī m., amīca, amīcae, f., friend (7) LL-PAIDEIA
amitto|āmittō, āmittere, āmīsī, āmissus, lose, let go (17) LL-PAIDEIA
amo|amō, amāre, amāvī, amātus, love (8) LL-PAIDEIA
amor|amor, amōris, m., love (17) LL-PAIDEIA
amoveo|āmoveō, āmovēre, āmōvī, āmōtus, move away (17) LL-PAIDEIA
amphitheatrum|amphitheātrum, -ī, n., amphitheater (11) LL-PAIDEIA
amphora|amphora, -ae, f., amphora, pitcher (14) LL-PAIDEIA
amplector|amplector, amplectī, amplexus sum, embrace, hug, grasp (26) LL-PAIDEIA
an|an, conj., whether, or (13) LL-PAIDEIA
anas|anas, anatis, f., duck (26) LL-PAIDEIA
angulus|angulus, -ī, m., corner (18) LL-PAIDEIA
anima|anima, -ae, f., soul, spirit (18) LL-PAIDEIA
animadverto|animadvertō, animadvertere, animadvertī, animadversus, pay attention to, notice, observe (22) LL-PAIDEIA
animal|animal, animālis, n., animal (8) LL-PAIDEIA
animus|animus, -ī, m., mind, intellect (18) LL-PAIDEIA
annus|annus, -ī, m., year (2) LL-PAIDEIA
ante|ante, prep. with acc., in front of, before (16) LL-PAIDEIA
antea|anteā, adv., before (21) LL-PAIDEIA
antehac|antehāc, adv., before now, earlier (30) LL-PAIDEIA
antequam|antequam, conj., before (23)  LL-PAIDEIA
antiquitus|antīquitus, adv., of old, in ancient times (25) LL-PAIDEIA
antiquus|antīquus, -a, -um, adj., old, ancient (7) LL-PAIDEIA
anulus|ānulus, -ī, m., ring (25) LL-PAIDEIA
aperio|aperiō, aperīre, aperuī, apertus, open (10) LL-PAIDEIA
apertus|apertus, -a, -um, adj., open (6) LL-PAIDEIA
appareo|appāreō, appārēre, appāruī, appāritus, appear, show up (27) LL-PAIDEIA
appello|appellō, appellāre, appellāvī, appellātus, call, name (16) LL-PAIDEIA
appropinquo|appropinquō, appropinquāre, appropinquāvī, appropinquātus, with dat. or ad + acc., approach (13) LL-PAIDEIA
aptus|aptus, -a, -um, adj., suitable (13) LL-PAIDEIA
apud|apud, prep. with acc., at, near, among (11) LL-PAIDEIA
aqua|aqua, aquae, f., water (13) LL-PAIDEIA
aquaeductus|aquaeductus, aquaeductūs, m., aqueduct (19) LL-PAIDEIA
ara|āra, -ae, f., altar (16) LL-PAIDEIA
araneus|arāneus, -ī, m., spider (21) LL-PAIDEIA
aratrum|arātrum, -ī, n., plow (19) LL-PAIDEIA
arbitror|arbitror, arbitrārī, arbitrātus sum, observe, judge, believe, think (18) LL-PAIDEIA
arbor|arbor, arboris, f., tree (11) LL-PAIDEIA
arca|arca, -ae, f., box (27) LL-PAIDEIA
arcesso|arcessō, arcessere, arcessīvī, arcessītus, summon, fetch (30) LL-PAIDEIA
architectus|architectus, -ī, m., architect, designer, builder (19) LL-PAIDEIA
arcus|arcus, -ūs, m., arch (23) LL-PAIDEIA
ardeo|ārdeō, ārdēre, ārsī, ārsus, burn (19) LL-PAIDEIA
area|ārea, -ae, f., area, space, site (24) LL-PAIDEIA
armarium|armārium, -iī, n., cabinet, closet (23) LL-PAIDEIA
arma|arma, -ōrum, n., weapons (17)  LL-PAIDEIA
armum|arma, -ōrum, n., weapons (17)  LL-PAIDEIA
ars|ars, artis, f., skill, art, knowledge (11) LL-PAIDEIA
artifex|artifex, artificis, m./f., artist (26) LL-PAIDEIA
ascendo|ascendō, ascendere, ascendī, ascēnsus, climb up (14) LL-PAIDEIA
aspicio|aspiciō, aspicere, aspexī, aspectus, look at, see (13) LL-PAIDEIA
assentior|assentior, assentīrī, assēnsus sum, agree, approve (18) LL-PAIDEIA
at|at, conj., but (21) LL-PAIDEIA
ater|āter, ātra, ātrum, adj., dark, gloomy (15) LL-PAIDEIA
athleticus|āthlēticus, -a, -um, adj., athletic, sporty (29) LL-PAIDEIA
atque|atque, conj., and (16) LL-PAIDEIA
atrium|ātrium, -iī, n., atrium, entrance hall (23) LL-PAIDEIA
attingo|attingō, attingere, attigī, attāctus, touch (24) LL-PAIDEIA
auctor|auctor, auctōris, m./f., author (27) LL-PAIDEIA
auctoritas|auctōritās, auctōritātis, f., power, authority (26) LL-PAIDEIA
audio|audiō, audīre, audīvī, audītus, hear (5) LL-PAIDEIA
aufero|auferō, auferre, abstulī, ablātus, carry away, remove (15) LL-PAIDEIA
aufugio|aufugiō, aufugere, aufūgī, —, run away (25) LL-PAIDEIA
augurium|augurium, -iī, n., augury, divination (24) LL-PAIDEIA
aula|aula, -ae, f., hall, room (22) LL-PAIDEIA
aureus|aureus, -a, -um, adj., golden (25) LL-PAIDEIA
auris|auris, auris, f., ear (24) LL-PAIDEIA
aurora|aurōra, -ae, f., dawn, sunrise (29) LL-PAIDEIA
ausculto|auscultō, auscultāre, auscultāvī, auscultātus, listen to (24) LL-PAIDEIA
aut|aut, conj., or; aut...aut, either...or (16) LL-PAIDEIA
autem|autem, conj., but, however (14) LL-PAIDEIA
auxilium|auxilium, -iī, n., help, assistance (16) LL-PAIDEIA
avis|avis, avis, f., bird (8) LL-PAIDEIA
avacatum|avacātum, -ī, n., avocado (15) LL-PAIDEIA
avolo|āvolō, āvolāre, āvolāvī, āvolātus, fly away, flee, vanish (18) LL-PAIDEIA
balneum|balneum, -ī, n., bath, bathtub (27) LL-PAIDEIA
balo|bālō, bālāre, bālāvī, bālātus, bleat, baa like a sheep (23) LL-PAIDEIA
barbarus|barbarus, -a, -um, adj., foreign; barbarian, savage (20) LL-PAIDEIA
barrio|barriō, barrīre, —, —, trumpet like an elephant (23) LL-PAIDEIA
basiatio|basiātiō, basiātiōnis, f., kiss (17) LL-PAIDEIA
basilica|basilica, -ae, f., basilica, church (19) LL-PAIDEIA
basio|bāsiō, bāsiāre, bāsiāvī, bāsiātus, to kiss (25) LL-PAIDEIA
basium|bāsium, -iī, n., kiss (17) LL-PAIDEIA
bellum|bellum, -ī, n., war, warfare (23) LL-PAIDEIA
bellus|bellus, -a, -um, adj., pretty, charming, lovely; fine, excellent (26) LL-PAIDEIA
bene|bene, comp. melius, superl. optimē, adv., well, favorably; better; best (2) LL-PAIDEIA
benedico|benedīcō, benedīcere, benedīxī, benedictus, bless (29) LL-PAIDEIA
benignitas|benignitās, benignitātis, f., kindness; benevolence, favor (24) LL-PAIDEIA
benignus|benignus, -a, -um, adj., kind; friendly, pleasant (9) LL-PAIDEIA
bestia|bēstia, -ae, f., beast, animal (9) LL-PAIDEIA
bestiola|bēstiola, -ae, f., little creature (25) LL-PAIDEIA
bibliotheca|bibliothēca, -ae, f., library (22) LL-PAIDEIA
bibo|bibō, bibere, bibī, —, drink (13) LL-PAIDEIA
biremis|birēmis, birēme, adj., two-oared, having two banks of oars (26) LL-PAIDEIA
birota|birota, -ae, f., two-wheeled vehicle; bicycle (25) LL-PAIDEIA
bis|bis, adv., twice, two times (22) LL-PAIDEIA
blandus|blandus, -a, -um, adj., flattering, charming, pleasant; gentle (18) LL-PAIDEIA
bonus|bonus, -a, -um, comp. melior, superl. optimus, adj., good; honest, kind, pleasant; right (7) LL-PAIDEIA
bos|bōs, bovis, m./f., cow; bull, ox (23) LL-PAIDEIA
braca|brāca, -ae, f., pants; trousers (25) LL-PAIDEIA
brachium|brāchium, -iī, n., arm (26) LL-PAIDEIA
brevis|brevis, breve, adj., short; brief, quick (20) LL-PAIDEIA
breviter|breviter, adv., shortly; briefly, quickly (21) LL-PAIDEIA
bubo|būbō, būbōnis, m., owl (29) LL-PAIDEIA
cachinno|cachinnō, cachinnāre, cachinnāvī, cachinnātus, laugh out loud, guffaw (22) LL-PAIDEIA
cachinnus|cachinnus, -ī, m., loud, boisterous laugh; guffaw (22) LL-PAIDEIA
cado|cadō, cadere, cecidī, cāsus, fall, sink, drop; die; decay (15) LL-PAIDEIA
caelestis|caelestis, caeleste, adj., celestial, heavenly; from the sky (15) LL-PAIDEIA
caelum|caelum, -ī, n., sky, heaven, weather (12) LL-PAIDEIA
caementum|caementum, -ī, n., cement (19) LL-PAIDEIA
caeruleus|caeruleus, -a, -um, adj., blue, cerulean (27) LL-PAIDEIA
cafearius|cafēārius, -a, -um, adj., of coffee (29) LL-PAIDEIA
caffea|caffea, -ae, f., coffee (21) LL-PAIDEIA
calceus|calceus, -ī, m., shoe (25) LL-PAIDEIA
calidus|calidus, -a, -um, adj., warm, hot (15) LL-PAIDEIA
callidus|callidus, -a, -um, adj., crafty, sly, cunning; clever, ingenious (27) LL-PAIDEIA
campus|campus, -ī, m., plain, field; park (15) LL-PAIDEIA
candidus|candidus, -a, -um, adj., white; bright, clear (20) LL-PAIDEIA
canis|canis, canis, m./f., dog (3) LL-PAIDEIA
canna|canna, -ae, f., reed (24) LL-PAIDEIA
cano|canō, canere, cecinī, cantus, sing, chant; play an instrument or a song (19) LL-PAIDEIA
canto|cantō, cantāre, cantāvī, cantātus, sing, play music; recite, celebrate (6) LL-PAIDEIA
capillus|capillus, -ī, m., hair, single hair (27) LL-PAIDEIA
capio|capiō, capere, cēpī, captus, take, take hold; seize, grasp (12) LL-PAIDEIA
capto|captō, captāre, captāvī, captātus, catch, capture (17) LL-PAIDEIA
caput|caput, capitis, n., head; leader, top (17) LL-PAIDEIA
cardinalis|cardinālis, cardinālis, m., cardinal (church official) (22) LL-PAIDEIA
careo|careō, carēre, caruī, caritus, lack, be without something (+ abl.) (27) LL-PAIDEIA
carmen|carmen, carminis, n., song; poem, play (11) LL-PAIDEIA
caro|caro, carnis, f., meat, flesh (15) LL-PAIDEIA
carpo|carpō, carpere, carpsī, carptus, seize, pick (29) LL-PAIDEIA
carus|cārus, -a, -um, adj., dear, beloved; precious, expensive (10) LL-PAIDEIA
casa|casa, -ae, f., cottage, hut; home, house (22) LL-PAIDEIA
caseus|cāseus, -ī, m., cheese (13) LL-PAIDEIA
cassus|cassus, -a, -um, adj., empty of, lacking (+ abl.) (15) LL-PAIDEIA
castellum|castellum, -ī, n., castle, fortress (30) LL-PAIDEIA
castigo|castīgō, castīgāre, castīgāvī, castīgātus, chastise, punish; reprimand (27) LL-PAIDEIA
casus|cāsus, -ūs, m., grammatical case; occurrence, event; accident, misfortune (5) LL-PAIDEIA
catena|catēna, -ae, f., chain, fetter; bond (30) LL-PAIDEIA
caupo|caupō, caupōnis, m., innkeeper, keeper of a tavern (20) LL-PAIDEIA
caupona|caupōna, -ae, f., inn, tavern; restaurant (20) LL-PAIDEIA
causa|causā, prep. with gen., for the sake of, for the purpose of (preceded by gen.) (21) LL-PAIDEIA
causa|causa, -ae, f., cause, reason (16) LL-PAIDEIA
cavea|cavea, -ae, f., cage, birdcage (12) LL-PAIDEIA
caveo|caveo, cavere, cavi, cautus, beware, watch out; avoid  (22) LL-PAIDEIA
cavum|cavum, -ī, n., cave, cavern; hole, hollow (24) LL-PAIDEIA
celeber|celeber, celebris, superl. celeberrimus, adj., famous, celebrated; renowned (13) LL-PAIDEIA
celeriter|celeriter, superl. celerrimē, adv., quickly, rapidly; at once (20) LL-PAIDEIA
celo|cēlō, cēlāre, cēlāvī, cēlātus, conceal, hide (25) LL-PAIDEIA
cena|cēnā, -ae, f., dinner, supper (17) LL-PAIDEIA
cenaculum|cēnāculum, -ī, n., dining room (12) LL-PAIDEIA
ceno|cēnō, cēnāre, cēnāvī, cēnātus, dine; eat dinner (20) LL-PAIDEIA
centralis|centrālis, centrāle, adj., central, centrally located; in the middle, center (26) LL-PAIDEIA
centum|centum, num., one hundred (13) LL-PAIDEIA
certe|certē, adv., surely, certainly; for sure; at any rate, in any case (6) LL-PAIDEIA
certus|certus, -a, -um, adj., firm, certain, sure (22) LL-PAIDEIA
cesso|cessō, cessāre, cessāvī, cessātus, cease from, stop (29) LL-PAIDEIA
ceterus|cēterus, -a, -um, the other, the others (pl.); the remaining, the rest (1) LL-PAIDEIA
charta|charta, -ae, f., paper; sheet of paper (27) LL-PAIDEIA
charteus|charteus, -a, -um, adj., made of paper (29) LL-PAIDEIA
chorda|chorda, -ae, f., string of a musical instrument (28) LL-PAIDEIA
chorus|chorus, -ī, m., chorus, choir (15) LL-PAIDEIA
Christianus|Chrīstiānus, -a, -um, adj., Christian (25) LL-PAIDEIA
cibus|cibus, -ī, m., food (12) LL-PAIDEIA
circa|circā, prep. with acc., around, about (21) LL-PAIDEIA
circulus|circulus, -ī, m., circle, ring (28) LL-PAIDEIA
circum|circum, prep. with acc., around, in a circle around (10) LL-PAIDEIA
circumcurro|circumcurrō, circumcurrere, circumcurrī, circumcursus, run around (10) LL-PAIDEIA
circumdo|circumdō, circumdare, circumdedī, circumdatus, surround, envelop; place around (25) LL-PAIDEIA
circumsedeo|circumsedeō, circumsedēre, circumsēdī, circumsessus, sit around (18) LL-PAIDEIA
circumspergo|circumspergō, circumspergere, circumspersī, circumspersus, spread around, strew (30) LL-PAIDEIA
circumspicio|circumspiciō, circumspicere, circumspexī, circumspectus, look around, survey; search for (15) LL-PAIDEIA
circumsto|circumstō, circumstāre, circumstetī, circumstatus, stand around, crowd around; surround (16) LL-PAIDEIA
cithara|cithara, -ae, f., cithara, lyre; guitar (19) LL-PAIDEIA
cito|citō, citāre, citāvī, citātus, cite, quote (30) LL-PAIDEIA
cito|citō, comp. citius, superl. citissimē, adv., quickly, speedily (26) LL-PAIDEIA
civilis|cīvīlis, cīvīle, adj., civil (24) LL-PAIDEIA
civis|cīvis, cīvis, m./f., citizen, fellow citizen; a Roman citizen (19) LL-PAIDEIA
civitas|cīvitās, cīvitātis f., community, city, town; state; city-state, kingdom (4) LL-PAIDEIA
clamo|clāmō, clāmāre, clāmāvī, clāmātus, cry out, shout, yell (3) LL-PAIDEIA
clamor|clāmor, clāmōris, m., shout; loud noise, din (12) LL-PAIDEIA
clarus|clārus, -a, -um adj., clear, bright, gleaming; evident, distinct; illustrious, famous (12) LL-PAIDEIA
claudo|claudō, claudere, clausī, clausus, close, shut (6) LL-PAIDEIA
clavis|clāvis, clāvis, f., key (27) LL-PAIDEIA
clementia|clēmentia, -ae, f., clemency, mercy (27) LL-PAIDEIA
cliens|cliēns, clientis, m./f., client, dependent (of a patron) (16) LL-PAIDEIA
coepio|coepiō, coepere, coepī, coeptus, begin, commence (24) LL-PAIDEIA
cogitatio|cōgitātiō, cōgitātiōnis, f., reflection, thought (25) LL-PAIDEIA
cogito|cōgitō, cōgitāre, cōgitāvī, cōgitātus, think, imagine; ponder (13) LL-PAIDEIA
cognosco|cognōscō, cognōscere, cognōvī, cognitus, know, get to know; recognize, be aware of; learn (18) LL-PAIDEIA
cogo|cōgō, cōgere, coēgī, coāctus, force, compel (22) LL-PAIDEIA
colligo|colligō, colligere, collēgī, collēctus, collect, gather (29) LL-PAIDEIA
collis|collis, collis, m., hill (14) LL-PAIDEIA
colloquium|colloquium, -iī, n., talk, conversation (2) LL-PAIDEIA
colloquor|colloquor, colloquī, collocūtus sum, talk, speak to/with; converse, discuss (18) LL-PAIDEIA
colo|colō, colere, coluī, cultus, till, cultivate; foster, maintain, tend; honor, cherish (19) LL-PAIDEIA
color|color, colōris, m., color (14) LL-PAIDEIA
colosseus|colossēus, -a, -um, adj., colossal, huge, gigantic (11) LL-PAIDEIA
columba|columba, -ae, f., pigeon, dove (18) LL-PAIDEIA
columna|columna, -ae, f., column, pillar (24) LL-PAIDEIA
coma|coma, -ae, f., hair (21) LL-PAIDEIA
comedo|comedō, comedere, comēdī, comēsus, eat up; consume, devour (12) LL-PAIDEIA
comes|comes, comitis, m./f., comrade, companion (20) LL-PAIDEIA
comitor|comitor, comitārī, comitātus sum, accompany, follow; go, come with (22) LL-PAIDEIA
commoveo|commoveō, commovēre, commōvī, commōtus, shake, stir up agitate; disturb, trouble (27) LL-PAIDEIA
communis|commūnis, commūne, adj., common, public; shared by all (27) LL-PAIDEIA
compleo|compleō, complēre, complēvī, complētus, fill; occupy space (25) LL-PAIDEIA
compono|compōnō, compōnere, composuī, compositus, construct, build, make up; compose (of songs, poetry, etc.) (29) LL-PAIDEIA
concavus|concavus, -a, -um, adj., vaulted, arched (28) LL-PAIDEIA
conclave|conclāve, conclāvis, n., room, chamber (23) LL-PAIDEIA
concordia|concordia, -ae, f., harmony, peace; Concordia, the goddess Concord (16) LL-PAIDEIA
concumbo|concumbō, concumbere, concubuī, concubitus, lie with (24) LL-PAIDEIA
concupisco|concupīscō, concupīscere, concupīvī, concupītus, desire eagerly; wish strongly (25) LL-PAIDEIA
condo|condō, condere, condidī, conditus, found, build, establish; store up, put away, preserve; bottle (wine); bury, inter (14) LL-PAIDEIA
condio|condiō, condīre, condīvī, condītus, season food (17) LL-PAIDEIA
conduco|condūcō, condūcere, condūxī, conductus, hire, rent for one’s own use (26) LL-PAIDEIA
confero|cōnferō, cōnferre, contulī, collātus, convey, bear, direct (16) LL-PAIDEIA
confundo|cōnfundō, cōnfundere, cōnfūdī, cōnfūsus, confuse, mix up (23) LL-PAIDEIA
congregatio|congregātiō, congregātiōnis, f., association, gathering (19) LL-PAIDEIA
coniunx|coniūnx, coniugis, m./f., spouse, marital partner (9) LL-PAIDEIA
conjunx|coniūnx, coniugis, m./f., spouse, marital partner (9) LL-PAIDEIA
conniveo|cōnnīveō, cōnnīvēre, cōnnīvī, —, close one’s eyes (30) LL-PAIDEIA
conor|cōnor, cōnārī, cōnātus sum, try, attempt to (18) LL-PAIDEIA
consentio|cōnsentiō, cōnsentīre, cōnsēnsī, cōnsēnsus, agree, consent; be of the same mind (23) LL-PAIDEIA
consido|cōnsīdō, cōnsīdere, cōnsēdī, cōnsessus, sit down, be seated (7) LL-PAIDEIA
consilium|cōnsilium, -iī, n., plan; idea, suggestion (16) LL-PAIDEIA
consisto|cōnsistō, cōnsistere, cōnstitī, cōnstitus, stop, stop moving; stand still (5) LL-PAIDEIA
conspicio|cōnspiciō, cōnspicere, cōnspexī, cōnspectus, observe, catch sight of; be visible (27) LL-PAIDEIA
constituo|cōnstituō, cōnstituere, cōnstituī, cōnstitūtus, decide, resolve (24) LL-PAIDEIA
consto|cōnstō, cōnstāre, cōnstitī, cōnstātus, cost (+ abl.); be established, constant, agreed upon (13) LL-PAIDEIA
construo|cōnstruō, cōnstruere, cōnstrūxī, cōnstrūctus, construct, build (19) LL-PAIDEIA
consumo|cōnsūmō, cōnsūmere, cōnsūmpsī, cōnsūmptus, consume, eat (20) LL-PAIDEIA
contemno|contemnō, contemnere, contempsī, contemptus, think little of, look down on (23) LL-PAIDEIA
contemplor|contemplor, contemplārī, contemplātus sum observe, gaze, contemplate (29) LL-PAIDEIA
contemplo|contemplor, contemplārī, contemplātus sum observe, gaze, contemplate (29) LL-PAIDEIA
contignatio|contignātiō, contignātiōnis, f., story, floor (27) LL-PAIDEIA
continens|continens, continentis, f., mainland, continent (4) LL-PAIDEIA
contorqueo|contorqueō, contorquēre, contorsī, contortus, twist, whirl, fling (21) LL-PAIDEIA
contra|contrā, prep. with acc., against (24) LL-PAIDEIA
contraho|contrahō, contrahere, contrāxī, contrāctus, bring in, draw together (21) LL-PAIDEIA
contubernalis|contubernālis, contubernālis, m., tent mate, companion (21) LL-PAIDEIA
conubium|cōnūbium, -iī, n., marriage (17) LL-PAIDEIA
convenio|conveniō, convenīre, convēnī, conventus, come together, meet (19) LL-PAIDEIA
converto|convertō, convertere, conversī, conversus, turn, convert (18) LL-PAIDEIA
coquo|coquō, coquere, coxī, coctus, cook (17) LL-PAIDEIA
cor|cor, cordis, n., heart (24) LL-PAIDEIA
corium|corium, -iī, n., hide, leather (27) LL-PAIDEIA
corpus|corpus, corporis, n., body (15) LL-PAIDEIA
corrigo|corrigō, corrigere, corrēxī, corrēctus, correct (22) LL-PAIDEIA
cottidie|cottīdiē, adv., daily, every day (16) LL-PAIDEIA
coxa|coxa, -ae, f., hip (22) LL-PAIDEIA
cras|crās, adv., tomorrow (17) LL-PAIDEIA
credo|crēdō, crēdere, crēdidī, crēditus, believe, trust (13) LL-PAIDEIA
crimen|crīmen, crīminis, n., crime, offense (24) LL-PAIDEIA
crus|crūs, crūris, n., leg (27) LL-PAIDEIA
crustulum|crustulum, -ī, n., cookie (13) LL-PAIDEIA
cubiculum|cubiculum, -ī, n., bedroom (6) LL-PAIDEIA
cubitus|cubitus, -ī, m., elbow (21) LL-PAIDEIA
culina|culīna, -ae, f., kitchen (23) LL-PAIDEIA
culinarius|culīnārius, -a, -um, adj., culinary, pertaining to the kitchen (17) LL-PAIDEIA
culpo|culpō, culpāre, culpāvī, culpātus, blame, find fault with, censure, condemn (21) LL-PAIDEIA
culter|culter, cultrī, m., knife (12) LL-PAIDEIA
cultus|cultus, -ūs, m., culture (26) LL-PAIDEIA
cum|cum, conj., when, since (12) LL-PAIDEIA
cum|cum, prep. with abl., with (8) LL-PAIDEIA
cunctus|cūnctus, -a, -um, adj., all, whole, entire (29) LL-PAIDEIA
cupido|cupīdō, cupīdinis, f., desire, love, lust; Cupīdō, m., the god of love, Cupid, son of Venus (7) LL-PAIDEIA
cupio|cupiō, cupere, cupīvī, cupītus, desire, want (11) LL-PAIDEIA
cupressus|cupressus, -ī, f., cypress tree (23) LL-PAIDEIA
cur|cūr, adv., why (9) LL-PAIDEIA
cura|cūra, -ae, f., care, attention (18) LL-PAIDEIA
Curia|Cūria, -ae, f., senate, meeting house (19) LL-PAIDEIA
curia|Cūria, -ae, f., senate, meeting house (19) LL-PAIDEIA
curo|cūrō, cūrāre, cūrāvī, cūrātus, take care of, provide for, care for (7) LL-PAIDEIA
curro|currō, currere, cucurrī, cursus, run (8) LL-PAIDEIA
cursus|cursus, -ūs, m., running, course; Via Cursūs, the Via del Corso, a main street in Rome (25) LL-PAIDEIA
curvatus|curvātus, -a, -um, adj., curved (28) LL-PAIDEIA
custodio|cūstōdiō, cūstōdīre, cūstōdīvī, cūstōdītus, guard, watch over (19) LL-PAIDEIA
custos|cūstōs, cūstōdis, m./f., guard, guardian, protector; cūstōs pūblicus, police officer (22) LL-PAIDEIA
de|dē, prep. with abl., down from, from; about, concerning (6) LL-PAIDEIA
debeo|dēbeō, dēbēre, dēbuī, dēbitus, owe; ought, must, should (+ infin.) (16) LL-PAIDEIA
decem|decem, num., ten (1) LL-PAIDEIA
decoro|decorō, decorāre, decorāvī, decorātus, adorn, embellish (27) LL-PAIDEIA
decus|decus, decōris, n., beauty, adornment, ornament (27) LL-PAIDEIA
decutio|dēcutiō, dēcutere, dēcussī, dēcussus, shake, strike, knock down (24) LL-PAIDEIA
dedico|dēdicō, dēdicāre, dēdicāvī, dēdicātus, dedicate, devote (24) LL-PAIDEIA
defigo|dēfīgō, dēfīgere, dēfīxī, dēfīxus, fix, focus (26) LL-PAIDEIA
defunctus|dēfūnctus, -a, -um, adj., dead, deceased (9) LL-PAIDEIA
dehinc|dehinc, adv., henceforth, from here on (29) LL-PAIDEIA
deinde|deinde, adv., then, next, afterward (14) LL-PAIDEIA
delecto|dēlectō, dēlectāre, dēlectāvī, dēlectātus, delight, please, amuse (27) LL-PAIDEIA
deleo|dēleō, dēlēre, dēlēvī, dēlētus, destroy completely, demolish, ruin (29) LL-PAIDEIA
deludo|dēlūdō, dēlūdere, dēlūsī, dēlūsus, deceive (29) LL-PAIDEIA
demitto|dēmittō, dēmittere, dēmīsī, dēmissus, send down, dismiss, let go (24) LL-PAIDEIA
demonstro|dēmōnstrō, dēmōnstrāre, dēmōnstrāvī, dēmōnstrātus, show, demonstrate (22) LL-PAIDEIA
demoror|dēmoror, dēmorārī, dēmorātus, delay, linger, stay (28) LL-PAIDEIA
denique|dēnique, adv., finally, and then (15) LL-PAIDEIA
dens|dēns, dentis, m., tooth (14) LL-PAIDEIA
depello|dēpellō, dēpellere, dēpulī, dēpulsus, drive out, repel, expel (24) LL-PAIDEIA
depingo|dēpingō, dēpingere, dēpīnxī, dēpictus, paint, depict, portray (23) LL-PAIDEIA
depono|dēpōno, dēpōnere, dēposuī, dēpositus, lift off; put down, set aside (13) LL-PAIDEIA
descendo|dēscendō, dēscendere, dēscendī, dēscēnsus, descend, go down (27) LL-PAIDEIA
describo|dēscrībō, dēscrībere, dēscrīpsī, dēscrīptus, describe (24) LL-PAIDEIA
desidero|dēsīdero, dēsīderāre, dēsīderāvī, dēsīderātus, long for, miss; desire (11) LL-PAIDEIA
desino|dēsinō, dēsinere, dēsīvī, dēsitus, stop, cease (15) LL-PAIDEIA
desisto|dēsistō, dēsistere, dēstitī, dēstitus, stop, cease, desist (from) (14) LL-PAIDEIA
desperatio|dēspērātiō, dēspērātiōnis, f., desperation (30) LL-PAIDEIA
despero|dēspērō, dēspērāre, dēspērāvī, dēspērātus, despair, have no hope (28) LL-PAIDEIA
deus|deus, deī, m., god (9) LL-PAIDEIA
devasto|dēvāstō, dēvāstāre, dēvāstāvī, dēvāstātus, devastate, ravage (23) LL-PAIDEIA
dexter|dexter, dextra, dextrum, right (hand) (15) LL-PAIDEIA
dico|dīcō, dīcere, dīxī, dictus, say, declare (2) LL-PAIDEIA
dies|diēs, diēī, m./f., day (15) LL-PAIDEIA
difficilis|difficilis, difficile, superl. difficillimus, difficult, troublesome, hard (12) LL-PAIDEIA
difficultas|difficultās, difficultātis, f., difficulty, trouble (15) LL-PAIDEIA
digitus|digitus, digitī, m., finger (12) LL-PAIDEIA
diploma|dīplōma, dīplōmatis, n., passport (28) LL-PAIDEIA
discedo|discēdō, discēdere, discessī, discessus, depart (16) LL-PAIDEIA
discipula|discipula, -ae, f., female student (2) LL-PAIDEIA
discipulus|discipulus, -ī, m., male student (2) LL-PAIDEIA
disco|discō, discere, didicī, discitus, learn (7) LL-PAIDEIA
disertus|disertus, -a, -um, adj., eloquent (16) LL-PAIDEIA
disputatio|disputātiō, disputātiōnis, f., discussion, debate, argument (24) LL-PAIDEIA
disputo|disputō, disputāre, disputāvī, disputātus, discuss, debate, argue (13) LL-PAIDEIA
dissentio|dissentiō, dissentīre, dissēnsī, dissēnsus, dissent, disagree (22) LL-PAIDEIA
dissimilis|dissimilis, dissimile, superl. dissimillimus, adj., unlike, different, dissimilar (19) LL-PAIDEIA
dissimulo|dissimulō, dissimulāre, dissimulāvī, dissimulātus, conceal, dissemble, disguise (23) LL-PAIDEIA
distans|distāns, distantis, adj., distant, separate (25) LL-PAIDEIA
disto|distō, distāre, —, —, stand apart, be distant (14) LL-PAIDEIA
distraho|distrahō, distrahere, distrāxī, distractus, draw apart, tear away, separate (29) LL-PAIDEIA
diu|diū, diūtius, diūtissimē, adv., for a long time (18) LL-PAIDEIA
dives|dīves, dīvitis, adj., rich, wealthy; subst. rich person (16) LL-PAIDEIA
divinus|dīvīnus, -a, -um, adj., divine (13) LL-PAIDEIA
do|dō, dare, dedī, datus, give (11) LL-PAIDEIA
doceo|doceō, docēre, docuī, doctus, teach, show (7) LL-PAIDEIA
doctus|doctus, -a, -um, adj., learned, wise, skilled (16) LL-PAIDEIA
dollarium|dollārium, -iī, n., dollar (13) LL-PAIDEIA
dolor|dolor, dolōris, m., pain, anguish, grief, sorrow (13); prōh dolor, interj., alas, unfortunately; what a shame LL-PAIDEIA
dolus|dolus, -ī, m., trick, deceit, trickery (23) LL-PAIDEIA
domesticus|domesticus, -a, -um, adj., domestic, of the house, familiar (30) LL-PAIDEIA
dominus|dominus, -ī, m., lord, master (21) LL-PAIDEIA
domus|domus, -ī or -ūs, f., house; domī: at home (6) LL-PAIDEIA
donum|dōnum, -ī, n., gift, present (28) LL-PAIDEIA
dormio|dormiō, dormīre, dormīvī, dormītus, sleep (3) LL-PAIDEIA
dubium|dubium, -iī, n., doubt (13) LL-PAIDEIA
ducenti|ducentī, two hundred (13) LL-PAIDEIA
duco|dūcō, dūcere, dūxi, ductus, lead, think, consider (16) LL-PAIDEIA
dulcis|dulcis, dulce, adj., sweet, pleasant (15) LL-PAIDEIA
dum|dum, conj., while, as long as, until, provided that (13) LL-PAIDEIA
duo|duo, duae, duo, num., two (1) LL-PAIDEIA
duodecim|duodecim, num., twelve (24) LL-PAIDEIA
duodeviginti|duodēvīgintī, num., eighteen (2) LL-PAIDEIA
durus|dūrus, -a, -um, adj., hard, stern, harsh (20) LL-PAIDEIA
dux|dux, ducis, m., leader, guide, commander, general (17) LL-PAIDEIA
ebrius|ēbrius, -a, -um, adj., drunk, intoxicated (18) LL-PAIDEIA
ecce|ecce, behold! see! look! (1) LL-PAIDEIA
ecclesia|ecclēsia, -ae, f., church, assembly (25) LL-PAIDEIA
edo|edō, edere, ēdī, ēsus, eat (15) LL-PAIDEIA
educo|ēdūcō, ēdūcere, ēdūxī, ēductus, lead out, draw up (17) LL-PAIDEIA
effugio|effugiō, effugere, effūgī, effugitus, flee, escape (25) LL-PAIDEIA
ego|ego, I, me (2) LL-PAIDEIA
egredior|ēgredior, ēgredī, ēgressus sum, go out (27) LL-PAIDEIA
eheu|ēheu, alas! (7) LL-PAIDEIA
elabor|ēlābor, ēlābī, ēlāpsus sum, slip away, escape (28) LL-PAIDEIA
electronicus|ēlectrōnicus, -a, -um, adj., electronic (11) LL-PAIDEIA
electrum|ēlectrum, -ī, n., amber (25) LL-PAIDEIA
elegans|ēlegāns, ēlegantis, adj., elegant, fine (25) LL-PAIDEIA
elephantus|elephantus, -ī, m., elephant (3) LL-PAIDEIA
eloquens|ēloquēns, ēloquentis, eloquent, articulate (16) LL-PAIDEIA
eloquentia|ēloquentia, -ae, f., eloquence (16) LL-PAIDEIA
eloquenter|ēloquenter, adv., eloquently (22) LL-PAIDEIA
eloquor|ēloquor, ēloquī, ēlocūtus sum, speak out, utter (22) LL-PAIDEIA
eludo|ēlūdō, ēlūdere, ēlūsī, ēlūsus, elude, escape from (30) LL-PAIDEIA
emineo|ēmineō, ēminēre, ēminuī, —, stand out, be prominent, project (23) LL-PAIDEIA
emo|emō, emere, ēmī, ēmptus, buy (13) LL-PAIDEIA
emptor|ēmptor, ēmptōris, m., buyer (13) LL-PAIDEIA
enim|enim, conj., for, in fact, indeed (15) LL-PAIDEIA
eo|eō, īre, īvī/iī, itus, go (12) LL-PAIDEIA
epistula|epistula, -ae, f., letter (11) LL-PAIDEIA
equidem|equidem, adv., truly, indeed, for my part (16) LL-PAIDEIA
equus|equus, -ī, m., horse (23) LL-PAIDEIA
ergo|ergō, adv., therefore (4) LL-PAIDEIA
eripio|ēripiō, ēripere, ēripuī, ēreptus, snatch away, rescue (15) LL-PAIDEIA
erro|errō, errāre, errāvī, errātus, wander, go astray; make a mistake (22) LL-PAIDEIA
eruditus|ērudītus, -a, -um, learned, skilled (22) LL-PAIDEIA
esurio|ēsuriō, ēsurīre, ēsurīvī, ēsurītus, be hungry (28) LL-PAIDEIA
et|et, conj., and; et … et: both … and (1) LL-PAIDEIA
etiam|etiam, conj., also, even (4) LL-PAIDEIA
etiamnunc|etiamnunc, adv., even now, still, yet (19) LL-PAIDEIA
etymologia|etymologia, -ae, f., etymology (30) LL-PAIDEIA
eurus|eurus, -ī, m., euro (13) LL-PAIDEIA
evanesco|ēvānēscō, ēvānēscere, ēvānuī, —, vanish, disappear (25) LL-PAIDEIA
eventus|ēventus, ēventūs, m., event, occurrence (23) LL-PAIDEIA
evito|ēvītō, ēvītāre, ēvītāvī, ēvītātus, shun, avoid (17) LL-PAIDEIA
ex|ex, prep. with abl., out of, from (12) LL-PAIDEIA
exanimus|exanimus, -a, -um, adj., dead, lifeless (15) LL-PAIDEIA
excipio|excipiō, excipere, excēpī, exceptus, take out, remove (29) LL-PAIDEIA
excito|excitō, excitāre, excitāvī, excitātus, wake up, excite, arouse (12) LL-PAIDEIA
exclamo|exclāmō, exclāmāre, exclāmāvī, exclāmātus, exclaim, shout, call out (7) LL-PAIDEIA
excrucio|excruciō, excruciāre, excruciāvī, excruciātus, torture, torment (15) LL-PAIDEIA
exemplum|exemplum, -ī, n., example; exemplī grātiā, for example (20) LL-PAIDEIA
exeo|exeō, exīre, exīvī/exiī, exitus, go out, leave (13) LL-PAIDEIA
exhaurio|exhauriō, exhaurīre, exhausī, exhaustus, draw out, drain, drink up (29) LL-PAIDEIA
existo|existō, existere, extitī, extitus, exist, be (15) LL-PAIDEIA
exonero|exonerō, exonerāre, exonerāvī, exonerātus, unload, disburden (23) LL-PAIDEIA
expello|expellō, expellere, expulī, expulsus, drive out, expel, banish (24) LL-PAIDEIA
explico|explicō, explicāre, explicāvī, explicātus, explain (18) LL-PAIDEIA
exprimo|exprimō, exprimere, expressī, expressus, express (25) LL-PAIDEIA
exquisitus|exquīsītus, -a, -um, choice, excellent, exquisite (25) LL-PAIDEIA
exspecto|exspectō, exspectāre, exspectāvī, exspectātus, await, expect (16) LL-PAIDEIA
exstinguo|exstinguō, exstinguere, exstīnxī, exstīnctus, extinguish, destroy (15) LL-PAIDEIA
exsto|exstō, exstāre, —, —, stand forth, exist (20) LL-PAIDEIA
extendo|extendō, extendere, extendī, extēnsus, stretch out, extend (23) LL-PAIDEIA
extra|extrā, prep. with acc., outside of, beyond (15) LL-PAIDEIA
extraordinarius|extraōrdinārius, -a, -um, adj., special, extraordinary (23) LL-PAIDEIA
exuo|exuō, exuere, exuī, exūtus, take off, strip off (27) LL-PAIDEIA
fabula|fābula, -ae, f., story, tale (7) LL-PAIDEIA
facies|faciēs, faciēī, f., face (15) LL-PAIDEIA
facilis|facilis, facile, superl. facillimus, adj., easy (15) LL-PAIDEIA
facio|faciō, facere, fēcī, factus, make, do, build (3) LL-PAIDEIA
falsus|falsus, -a, -um, adj., wrong, false, fictitious (13) LL-PAIDEIA
fames|famēs, famis, f., hunger (15) LL-PAIDEIA
familia|familia, -ae, f., family (8) LL-PAIDEIA
familiaris|familiāris, familiāre, adj., domestic, intimate (8) LL-PAIDEIA
famulus|famulus, -ī, m., slave, servant (29) LL-PAIDEIA
farcio|farciō, farcīre, farsī, fartus, stuff, fill up (29) LL-PAIDEIA
farina|farīna, -ae, f., flour (19) LL-PAIDEIA
fatum|fātum, -ī, n., fate, destiny (15) LL-PAIDEIA
fatuus|fatuus, -a, -um, adj., foolish, silly, idiotic (21) LL-PAIDEIA
feles|fēlēs, fēlis, f., cat (14) LL-PAIDEIA
feliciter|fēlīciter, adv., luckily, fortunately (29) LL-PAIDEIA
femina|fēmina, -ae, f., woman (1) LL-PAIDEIA
femininus|fēminīnus, -a, -um, adj., feminine; in the feminine gender (1) LL-PAIDEIA
femur|femur, femoris, n., thigh (27) LL-PAIDEIA
fenestra|fenestra, -ae, f., window (12) LL-PAIDEIA
fere|ferē, adv., almost, about (21) LL-PAIDEIA
fero|ferō, ferre, tulī, lātus, bring, bear (15) LL-PAIDEIA
ferociter|ferōciter, adv., fiercely, ferociously, aggressively (23) LL-PAIDEIA
fessus|fessus, -a, -um, adj., tired, wearied, exhausted (14) LL-PAIDEIA
festino|festīnō, festīnāre, festīnāvī, festīnātus, hasten, hurry (21) LL-PAIDEIA
fidus|fīdus, -a, -um, adj., faithful, loyal (18)  LL-PAIDEIA
filia|fīlia, -ae, f., daughter (9) LL-PAIDEIA
filius|fīlius, -iī, m., son (9) LL-PAIDEIA
fingo|fingō, fingere, fīnxī, fictus, imagine, invent (16) LL-PAIDEIA
finis|fīnis, fīnis, m./f., end, limit, boundary (23) LL-PAIDEIA
fio|fīō, fierī, factus sum, be made, become, happen (15) LL-PAIDEIA
flamma|flamma, -ae, f., flame, blaze (19) LL-PAIDEIA
flavus|flāvus, -a, -um, adj., yellow, golden, blonde (28) LL-PAIDEIA
fleo|fleō, flēre, flēvī, flētus, weep, cry for (16) LL-PAIDEIA
floreo|flōreō, flōrēre, flōruī, —, flourish, blossom, be prosperous (26) LL-PAIDEIA
flos|flōs, flōris, m., flower, blossom (30) LL-PAIDEIA
flumen|flūmen, flūminis, n., river (14) LL-PAIDEIA
fluo|fluō, fluere, flūxī, flūxus, flow (14) LL-PAIDEIA
focus|focus, -ī, m., hearth, fireplace (23) LL-PAIDEIA
foederatus|foederātus, -a, -um, adj., allied, federated, united (4) LL-PAIDEIA
foedo|foedō, foedāre, foedāvī, foedātus, make filthy, pollute, stain (30) LL-PAIDEIA
fons|fōns, fontis, m., fountain, source (26) LL-PAIDEIA
foras|forās, adv., outside, forth (15) LL-PAIDEIA
foris|forīs, adv., outside (16) LL-PAIDEIA
forma|fōrma, -ae, f., form, figure, shape; appearance (22) LL-PAIDEIA
fornax|fornāx, fornācis, f., furnace, oven (19) LL-PAIDEIA
fors|fors, fortis, f., chance, luck, fortune (29) LL-PAIDEIA
fortasse|fortasse, adv., perhaps, possibly (11) LL-PAIDEIA
fortis|fortis, forte, adj., strong, brave, bold (22) LL-PAIDEIA
fortiter|fortiter, adv., strongly, bravely, boldly (28) LL-PAIDEIA
forum|forum, -ī, n., market, forum (13) LL-PAIDEIA
frater|frāter, frātris, m., brother (9) LL-PAIDEIA
fremo|fremō, fremere, fremuī, fremitus, roar, growl (10) LL-PAIDEIA
frequens|frequēns, frequentis, adj., crowded, packed (30) LL-PAIDEIA
frigidarium|frīgidārium, -iī, n., cold room (of baths), refrigerator (20) LL-PAIDEIA
frons|frōns, frontis, f., front, facade (26) LL-PAIDEIA
frux|frūx, frūgis, f., crops (pl.), fruits (27) LL-PAIDEIA
fugio|fugiō, fugere, fūgī, fugitus, flee, run away, avoid (13) LL-PAIDEIA
fulgeo|fulgeō, fulgēre, fulsī, —, shine, glow (26) LL-PAIDEIA
fundo|fundō, fundere, fūdī, fūsus, pour (24) LL-PAIDEIA
fungor|fungor, fungī, fūnctus sum, with abl., perform, complete; finish, end (15) LL-PAIDEIA
funus|fūnus, fūneris, n., burial, funeral, death (15) LL-PAIDEIA
fur|fūr, fūris, m./f., thief, robber (21) LL-PAIDEIA
gallina|gallīna, -ae, f., chicken, hen (23) LL-PAIDEIA
garrio|garriō, garrīre, garrīvī, garrītus, chatter, prattle, talk nonsense (29) LL-PAIDEIA
garum|garum, -ī, n., fish-sauce (17) LL-PAIDEIA
gaudeo|gaudeō, gaudēre, gāvīsus sum, be glad, rejoice (12) LL-PAIDEIA
geminus|geminus, -a, -um, adj., twin, double (24) LL-PAIDEIA
gemma|gemma, -ae, f., jewel, gem (25) LL-PAIDEIA
gemo|gemō, gemere, gemuī, gemitus, moan, groan, lament (23) LL-PAIDEIA
gena|gena, -ae, f., cheek (30) LL-PAIDEIA
gens|gēns, gentis, f., tribe, clan, nation, people (27) LL-PAIDEIA
genus|genus, generis, n., kind, sort, class (25) LL-PAIDEIA
gero|gerō, gerere, gessī, gestus, bear, carry, wear (23) LL-PAIDEIA
gestio|gestiō, gestīre, gestīvī, gestītus, gesticulate (28) LL-PAIDEIA
glacies|glaciēs, glaciēī, f., ice; glaciēs dulcis, ice cream (15) LL-PAIDEIA
gladiator|gladiātor, gladiātōris, m., gladiator (17) LL-PAIDEIA
gladius|gladius, -iī, m., sword (17) LL-PAIDEIA
globus|globus, -ī, m., ball, sphere (22) LL-PAIDEIA
globosus|globōsus, -a, -um, adj., spherical (22) LL-PAIDEIA
gloria|glōria, -ae, f., glory, fame, ambition, renown (24) LL-PAIDEIA
gradior|gradior, gradī, gressus sum, walk, step, go (27) LL-PAIDEIA
gradus|gradus, -ūs, m., step, position (27) LL-PAIDEIA
grammaticus|grammaticus, -a, -um, adj., grammatical (18) LL-PAIDEIA
gratia|grātia, gratiae, f., thanks (pl.); with preceding gen., for the sake of (2) LL-PAIDEIA
graviter|graviter, adv., violently, severely; strongly, deeply (27) LL-PAIDEIA
grex|grex, gregis, m., flock, herd, crowd (29) LL-PAIDEIA
gusto|gustō, gustāre, gustāvī, gustātus, taste, sip, enjoy (17) LL-PAIDEIA
gustus|gustus, -ūs, m., taste (13) LL-PAIDEIA
habeo|habeō, habēre, habuī, habitus, have, hold (2) LL-PAIDEIA
habito|habitō, habitāre, habitāvī, habitātus, live, dwell (4) LL-PAIDEIA
haud|haud, adv., not, not at all, by no means (13) LL-PAIDEIA
herba|herba, -ae, f., grass (24) LL-PAIDEIA
heri|heri, adv., yesterday (16) LL-PAIDEIA
hesternus|hesternus, -a, -um, adj., of yesterday (29) LL-PAIDEIA
heu|heu, interj., ah! alas! (an expression of dismay or pain) (21) LL-PAIDEIA
heus|heus, interj., hey!, ho! (30) LL-PAIDEIA
hic|hīc, adv., here, in this place (14) LL-PAIDEIA
hic|hic, haec, hoc, pron., this, these (pl.) (13) LL-PAIDEIA
hinnio|hinniō, hinnīre, hinnīvī, hinnītus, neigh, whinny (23) LL-PAIDEIA
historia|historia, -ae, f., account, story, history (9) LL-PAIDEIA
histrio|histriō, histriōnis, m., actor (17) LL-PAIDEIA
hodie|hodiē, adv., today (4) LL-PAIDEIA
hodiernus|hodiernus, -a, -um, adj., today's, existing now, present day (20) LL-PAIDEIA
homo|homō, hominis, m., human being, person (1) LL-PAIDEIA
hora|hōra, -ae, f., hour, time (17) LL-PAIDEIA
horologium|hōrologium, -iī, n., clock, sundial (21) LL-PAIDEIA
horribilis|horribilis, horribile, adj., awful, horrible, terrible (28) LL-PAIDEIA
hortus|hortus, -ī, m., garden, park (pl.) (14) LL-PAIDEIA
hospes|hospes, hospitis, m., guest, stranger (20) LL-PAIDEIA
hostia|hostia, -ae, f., victim, sacrifice (16) LL-PAIDEIA
huc|hūc, adv., here, to this place, to this point (14) LL-PAIDEIA
humanus|hūmānus, -a, um, adj., human; kind, humane; cultured, refined (22) LL-PAIDEIA
humilis|humilis, humile, superl. humillimus, adj., low, lowly, humble (16) LL-PAIDEIA
humiliter|humiliter, adv., abjectly, humbly (16) LL-PAIDEIA
humus|humus, -ī, f., ground, earth (27) LL-PAIDEIA
iaceo|iaceō, iacēre, iacuī, iacitus, lie, lie down; lie prostrate (15) LL-PAIDEIA
jaceo|iaceō, iacēre, iacuī, iacitus, lie, lie down; lie prostrate (15) LL-PAIDEIA
iacio|iaciō, iacere, iēcī, iactus, throw, hurl (6) LL-PAIDEIA
jacio|iaciō, iacere, iēcī, iactus, throw, hurl (6) LL-PAIDEIA
iam|iam, adv., now, already; by now, even now; besides; nōn iam, no longer (4) LL-PAIDEIA
ianua|iānua, -ae, f., door, entrance (6) LL-PAIDEIA
janua|iānua, -ae, f., door, entrance (6) LL-PAIDEIA
ibi|ibi, adv., there, in that place (11) LL-PAIDEIA
ictus|ictus, -ūs, m., blow (17) LL-PAIDEIA
idcirco|idcircō, adv., on that account, therefore (23) LL-PAIDEIA
idem|īdem, eadem, idem, pron., the same (22) LL-PAIDEIA
ientaculum|ientāculum, -ī, n., breakfast (21) LL-PAIDEIA
jentaculum|ientāculum, -ī, n., breakfast (21) LL-PAIDEIA
igitur|igitur, conj., therefore, so, so then (23) LL-PAIDEIA
ignavus|ignāvus, -a, -um, adj., lazy, sluggish; mean, useless (18) LL-PAIDEIA
ignis|ignis, ignis, m., fire (19) LL-PAIDEIA
ignoro|ignōrō, ignōrāre, ignōrāvī, ignōrātus, not know, be ignorant of (23) LL-PAIDEIA
ignosco|ignōscō, ignōscere, ignōvī, ignōtus, pardon, forgive (+ dat.) (16) LL-PAIDEIA
ignotus|ignōtus, -a, -um, adj., unknown, strange; unfamiliar (13) LL-PAIDEIA
ilex|īlex, īlicis, f., holm-oak (26) LL-PAIDEIA
ille|ille, illa, illud, pron., that, those (13) LL-PAIDEIA
illic|illīc, adv., in that place, over there (14) LL-PAIDEIA
illiteratus|illiterātus, -a, -um, adj., illiterate (27) LL-PAIDEIA
illuc|illūc, adv., there, to that place; hūc et illūc, here and there (14) LL-PAIDEIA
illustris|illūstris, illūstre, adj., brilliant, illustrious, distinguished (16) LL-PAIDEIA
imago|imāgō, imāginis, f., image, picture; likeness; imāgō photographīca, photograph (11) LL-PAIDEIA
imber|imber, imbris, m., rain, shower, storm (29) LL-PAIDEIA
imitor|imitor, imitārī, imitātus sum, imitate, mimic (23) LL-PAIDEIA
imito|imitor, imitārī, imitātus sum, imitate, mimic (23) LL-PAIDEIA
immanis|immānis, immāne, adj., huge, immense; monstrous, frightful (23) LL-PAIDEIA
immo|immō, adv., no indeed (contradiction), on the contrary (15) LL-PAIDEIA
immortalis|immortālis, immortāle, adj., immortal (9) LL-PAIDEIA
immotus|immōtus, -a, -um, adj., motionless, unmoved (25) LL-PAIDEIA
imperator|imperātor, imperātōris, m., emperor (23) LL-PAIDEIA
imperium|imperium, imperiī, n., rule, supreme power; empire (10) LL-PAIDEIA
impero|imperō, imperāre, imperāvī, imperātus, order, command (+ dat.) (10) LL-PAIDEIA
impetus|impetus, impetūs, m., attack, assault (17) LL-PAIDEIA
impiger|impiger, impigra, impigrum, adj., active, energetic (18) LL-PAIDEIA
impius|impius, -a, -um, adj., wicked, impious (12) LL-PAIDEIA
impleo|impleō, implēre, implēvī, implētus, fill, fill up (27) LL-PAIDEIA
implico|implicō, implicāre, implicuī, implicitus, clasp, fold LL-PAIDEIA
impluvium|impluvium, -iī, n., basin in atrium floor to receive rain-water from roof (23) LL-PAIDEIA
impono|impōnō, impōnere, imposuī, impositus, put upon, set (27) LL-PAIDEIA
imprimis|imprīmīs, adv., in the first place, first (29) LL-PAIDEIA
imprimo|imprimō, imprimere, impressī, impressus, imprint, stamp (25) LL-PAIDEIA
improbus|improbus, -a, -um, adj., rude, shameless, impolite (16) LL-PAIDEIA
improvisus|imprōvīsus, -a, -um, adj., unforeseen, unexpected (28) LL-PAIDEIA
impurus|impūrus, -a, -um, adj., unclean, impure (27) LL-PAIDEIA
in|in, prep. with abl., in, on, at; against; within (time) (2) LL-PAIDEIA
in|in, prep. with acc., into, about (6) LL-PAIDEIA
incedo|incēdō, incēdere, incessī, incessus, advance, approach, move forward (29) LL-PAIDEIA
incertus|incertus, -a, -um, adj., uncertain (16) LL-PAIDEIA
incipio|incipiō, incipere, incēpī, inceptus, begin, start (15) LL-PAIDEIA
includo|inclūdō, inclūdere, inclūsī, inclūsus, enclose, confine (27) LL-PAIDEIA
incolo|incolō, incolere, incoluī, —, live, dwell in, inhabit (26) LL-PAIDEIA
incredibilis|incrēdibilis, incrēdibile, adj., incredible, extraordinary (25) LL-PAIDEIA
incultus|incultus, -a, -um, adj., uncultivated; rough, uncouth (26) LL-PAIDEIA
inde|inde, adv., thence, from there; from then (20) LL-PAIDEIA
index|index, indicis, m./f., list, catalogue; index cibōrum, menu (20) LL-PAIDEIA
indicativus|indicātīvus, -a, -um, adj., indicative, in the indicative mood (22) LL-PAIDEIA
indico|indicō, indicāre, indicāvī, indicātus, point out, point to; indicate (13) LL-PAIDEIA
induo|induō, induere, induī, indūtus, put on (clothing), dress oneself in (25) LL-PAIDEIA
ineo|ineō, inīre, inīvī/iniī, initus, enter, go into, go through (22) LL-PAIDEIA
inertia|inertia, -ae, f., inactivity, laziness, idleness (28) LL-PAIDEIA
infantula|īnfantula, -ae, f., baby girl (28) LL-PAIDEIA
inferus|īnferus, -a, -um, comp., īnferior, adj., lower (27) LL-PAIDEIA
inficio|īnficiō, īnficere, īnfēcī, īnfectus, corrupt, stain (24) LL-PAIDEIA
ingenium|ingenium, -iī, n., natural disposition, capacity; talent, ability (21) LL-PAIDEIA
ingredior|ingredior, ingredī, ingressus sum, enter, go into (24) LL-PAIDEIA
innocens|innocēns, innocentis, adj., harmless, innocent (29) LL-PAIDEIA
innocuus|innocuus, -a, -um, adj., innocent, harmless (18) LL-PAIDEIA
inquam|inquam, —, —, say (11) LL-PAIDEIA
inquiam|inquam, —, —, say (11) LL-PAIDEIA
inscribo|īnscrībō, īnscrībere, īnscrīpsī, īnscrīptus, write on, inscribe (22) LL-PAIDEIA
inscriptio|īnscrīptiō, īnscrīptiōnis, f., inscription (22) LL-PAIDEIA
insector|īnsector, īnsectārī, īnsectātus sum, pursue with hostile intent, chase (27) LL-PAIDEIA
insecto|īnsector, īnsectārī, īnsectātus sum, pursue with hostile intent, chase (27) LL-PAIDEIA
insolitus|īnsolitus, -a, -um, adj., unaccustomed, unusual (11) LL-PAIDEIA
inspicio|īnspiciō, īnspicere, īnspexī, īnspectus, examine, inspect, consider; look into, look at (15) LL-PAIDEIA
instrumentum|īnstrūmentum, -ī, n., tool, instrument (19) LL-PAIDEIA
insula|īnsula, -ae, f., island, apartment house (9) LL-PAIDEIA
integer|integer, integra, integrum, adj., sound, fresh, vigorous (26) LL-PAIDEIA
intellego|intellegō, intellegere, intellēxī, intellēctus, understand, realize (16) LL-PAIDEIA
inter|inter, prep. with acc., between, among, during; inter sē, to each other, mutually, amongst themselves (15) LL-PAIDEIA
interea|intereā, adv., meanwhile (6) LL-PAIDEIA
interficio|interficiō, interficere, interfēcī, interfectus, kill, slay (24) LL-PAIDEIA
interrete|interrēte, interrētis, n., internet (22) LL-PAIDEIA
interrumpo|interrumpō, interrumpere, interrūpī, interruptus, interrupt (28) LL-PAIDEIA
intra|intrā, prep. with acc., within, inside (23) LL-PAIDEIA
intro|intrō, intrāre, intrāvī, intrātus, enter, go into (6) LL-PAIDEIA
intueor|intueor, intuērī, intuitus sum, look at, stare, consider (30) LL-PAIDEIA
intus|intus, adv., inside, within (16) LL-PAIDEIA
invenio|inveniō, invenīre, invēnī, inventus, discover, find (14) LL-PAIDEIA
iocor|iocor, iocārī, iocātus sum, joke, jest (22) LL-PAIDEIA
joco|iocor, iocārī, iocātus sum, joke, jest (22) LL-PAIDEIA
iocus|iocus, -ī, m., joke, jest, sport (21) LL-PAIDEIA
jocus|iocus, -ī, m., joke, jest, sport (21) LL-PAIDEIA
ipse|ipse, ipsa, ipsum, pron., himself, herself, itself; the very one, in person; themselves (pl.) (16) LL-PAIDEIA
ira|īra, -ae, f., anger, wrath, rage (21) LL-PAIDEIA
irascor|īrāscor, īrāscī, īrātus sum, get angry, fly into a rage, be angry at (+ dat.) (21) LL-PAIDEIA
iratus|īrātus, -a, -um, adj., angry, enraged, furious (10) LL-PAIDEIA
is|is, ea, id, pron., he, she, it; they (9) LL-PAIDEIA
iste|iste, ista, istud, pron., that, that one; those, those ones (16) LL-PAIDEIA
ita|ita, adv., yes; thus, so, therefore (2) LL-PAIDEIA
itaque|itaque, adv., and so, therefore; accordingly, consequently (16) LL-PAIDEIA
item|item, adv., likewise, also; similarly (25) LL-PAIDEIA
iter|iter, itineris, n., journey, road, path (14) LL-PAIDEIA
iterum|iterum, adv., again, a second time, for the second time (2) LL-PAIDEIA
iubeo|iubeō, iubēre, iussī, iussus, order, command, tell (22) LL-PAIDEIA
jubeo|iubeō, iubēre, iussī, iussus, order, command, tell (22) LL-PAIDEIA
iucundus|iūcundus, -a, -um, adj., pleasant, agreeable (21) LL-PAIDEIA
jucundus|iūcundus, -a, -um, adj., pleasant, agreeable (21) LL-PAIDEIA
iungo|iungō, iungere, iūnxī, iūnctus, join, bring together (29) LL-PAIDEIA
jungo|iungō, iungere, iūnxī, iūnctus, join, bring together (29) LL-PAIDEIA
ius|iūs, iūris, n., sauce (17) LL-PAIDEIA
ius|iūs, iūris, n., law, right (17) LL-PAIDEIA
jus|iūs, iūris, n., sauce (17) LL-PAIDEIA
jus|iūs, iūris, n., law, right (17) LL-PAIDEIA
iuvenis|iuvenis, iuvenis, m./f., youth; young man, young woman (5) LL-PAIDEIA
juvenis|iuvenis, iuvenis, m./f., youth; young man, young woman (5) LL-PAIDEIA
iuxta|iuxtā, prep. with acc., near, close to, next to (24) LL-PAIDEIA
juxta|iuxtā, prep. with acc., near, close to, next to (24) LL-PAIDEIA
labia|labia, -ae, f., lip (27) LL-PAIDEIA
labor|labor, labōris, m.,  labor, work, task; toil, exertion (18) LL-PAIDEIA
laboriosus|labōriōsus, -a, -um, adj., laborious, painstaking, (18) LL-PAIDEIA
laboro|labōrō, labōrāre, labōrāvī, labōrātus, work, labor (14) LL-PAIDEIA
labrum|labrum, -ī, n., bowl, basin, tub (27) LL-PAIDEIA
labyrinthus|labyrinthus, -ī, m., labyrinth, maze (27) LL-PAIDEIA
lacertus|lacertus, -ī, m., upper arm, shoulder (27) LL-PAIDEIA
lacrima|lacrima, -ae, f., tear, lacrimās dare, shed tears (16) LL-PAIDEIA
lacrimo|lacrimō, lacrimāre, lacrimāvī, lacrimātus, cry, weep, shed tears (28) LL-PAIDEIA
lac|lac, lactis, n., milk (24) LL-PAIDEIA
lacus|lacus, -ūs, m., lake, pond (26) LL-PAIDEIA
laedo|laedō, laedere, laesī, laesus, hurt, injure, wound (17) LL-PAIDEIA
laetus|laetus, -a, -um, adj., happy, cheerful; fertile, prosperous (6) LL-PAIDEIA
laeto|laetō, laetāre, laetāvī, laetātus, make happy (18) LL-PAIDEIA
lagoena|lagoena, -ae, f., bottle; pitcher, flask (13) LL-PAIDEIA
langueo|langueō, languēre, —, —, be inactive, idle; languish (27) LL-PAIDEIA
Lar|Lār, Laris, m., Lares (usually pl.), tutelary gods of the home and hearth (23) LL-PAIDEIA
latrinum|lātrīnum, -ī, n., latrine, bathroom (23) LL-PAIDEIA
latro|lātrō, lātrāre, lātrāvī, lātrātus, bark (6) LL-PAIDEIA
latus|lātus, -a, -um, adj., wide, broad, extensive (18) LL-PAIDEIA
latus|latus, lateris, n., side, flank (18) LL-PAIDEIA
laudo|laudō, laudāre, laudāvī, laudātus, praise, recommend, extol (9) LL-PAIDEIA
lavo|lavō, lavāre, lāvī, lōtus, wash, bathe, soak (21) LL-PAIDEIA
lectio|lēctiō, lēctiōnis, f., lesson, lecture; reading (aloud) (16) LL-PAIDEIA
lectus|lectus, -ī, m., bed, couch (16) LL-PAIDEIA
lego|legō, legere, lēgī, lectus, read, gather (10) LL-PAIDEIA
lente|lentē, comp. lentius, adv., slowly (22) LL-PAIDEIA
letum|lētum, -ī, n., death (15) LL-PAIDEIA
libenter|libenter, adv., willingly, gladly, with pleasure (19) LL-PAIDEIA
liber|līber, lībera, līberum, adj., free (30) LL-PAIDEIA
liber|līber, līberī, m., child (17) LL-PAIDEIA
liber|liber, librī, m., book (6) LL-PAIDEIA
libero|līberō, līberāre, līberāvī, līberātus, free, liberate (30) LL-PAIDEIA
libertas|lībertās, lībertātis, f., freedom, liberty (20) LL-PAIDEIA
libra|lībra, -ae, f., pound, British pound (13) LL-PAIDEIA
licet|licet, licēre, licuit, licitus, it is allowed, it is permitted, one may (14) LL-PAIDEIA
ligneus|ligneus, -a, -um, adj., wooden, wood (27) LL-PAIDEIA
lignum|lignum, -ī, n., wood (30) LL-PAIDEIA
limen|līmen, līminis, n., threshold, entrance (24) LL-PAIDEIA
lingua|lingua, -ae, f., language, tongue, speech (7) LL-PAIDEIA
liquefacio|liquefaciō, liquefacere, liquefēcī, liquefactus, melt away, dissolve (26) LL-PAIDEIA
liquidus|liquidus, -a, -um, adj., liquid, flowing (27) LL-PAIDEIA
littera|littera, -ae, f., letter (of the alphabet), literature (pl.) (1) LL-PAIDEIA
litterator|litterātor, litterātōris, m., litterateur, literary critic; writer (27) LL-PAIDEIA
loco|locō, locāre, locāvī, locātus, situate, be located (26) LL-PAIDEIA
locus|locus, -ī, pl. locī/loca, m./n., place, location; literary passage (18) LL-PAIDEIA
longe|longē, adv., far off, distant, a long way away; greatly, very much (13) LL-PAIDEIA
longinquo|longinquō, adv., at a distance, from far away (28) LL-PAIDEIA
longus|longus, -a, -um, adj., long; taking a long time (14) LL-PAIDEIA
loquor|loquor, loqui, locutus sum, speak, talk, say, converse (18) LL-PAIDEIA
luceo|lūceō, lūcēre, lūxī, —, shine, be bright (26) LL-PAIDEIA
ludo|lūdō, lūdere, lūsī, lūsus, play, mock, tease, trick (8) LL-PAIDEIA
ludus|lūdus, -ī, m., school; game, play, entertainment (21) LL-PAIDEIA
lugeo|lūgeō, lūgēre, lūxī, lūctus, mourn, grieve, lament (26) LL-PAIDEIA
lumen|lūmen, lūminis, n., light, daylight (15) LL-PAIDEIA
luna|lūna, -ae, f., moon; another name for the goddess Diana (17) LL-PAIDEIA
lupa|lupa, -ae, f., she-wolf (24) LL-PAIDEIA
lux|lūx, lūcis, f., light, daylight; dawn; prīmā lūce, at daybreak (12) LL-PAIDEIA
lyra|lyra, -ae, f., lyre; lute, harp (24) LL-PAIDEIA
macellum|macellum, -ī, n., marketplace (13) LL-PAIDEIA
machina|machina, -ae, f., machine (29) LL-PAIDEIA
machinula|māchinula, -ae, f., little machine (25) LL-PAIDEIA
machinor|māchinor, māchinārī, māchinātus sum, devise, plot (27) LL-PAIDEIA
mactus|mactus, -a, -um, adj., honored, glorified; macte (voc.), bravo! well done! (17) LL-PAIDEIA
magis|magis, adv., more, to a greater extent; magis... quam, more than (15) LL-PAIDEIA
magister|magister, magistrī, m., teacher (4) LL-PAIDEIA
magnopere|magnopere, adv., greatly, exceedingly, very much (14) LL-PAIDEIA
magnus|magnus, -a, -um, comp. māior, superl. maximus, adj., large, great, big (4) LL-PAIDEIA
malignus|malignus, -a, -um, adj., spiteful, mean, petty (23) LL-PAIDEIA
malo|mālō, malle, māluī, —, prefer, would rather (15) LL-PAIDEIA
malus|malus, -a, -um, comp. pēior, superl. pessimus, adj., bad, evil, wicked (9) LL-PAIDEIA
mane|māne, adv., in the morning, early in the morning (16) LL-PAIDEIA
maneo|maneō, manēre, mānsī, mānsus, remain, stay, wait (6) LL-PAIDEIA
mantilium|mantīlium, -iī, n., towel, cloth (27) LL-PAIDEIA
manus|manus, -ūs, f., hand, fist; band, group (15) LL-PAIDEIA
mare|mare, maris, n., sea (18) LL-PAIDEIA
maritus|marītus, -ī, m., husband, married man (9) LL-PAIDEIA
marmoreus|marmoreus, -a, -um, adj., marble, made of marble (22) LL-PAIDEIA
mater|māter, mātris, f., mother, mom (9) LL-PAIDEIA
matutinus|mātūtīnus, -a, -um, adj., early, of the early morning (25) LL-PAIDEIA
maumo|maumō, maumāre, maumāvī, —, meow (23) LL-PAIDEIA
medianum|mediānum, -ī, n., lounge, living room (30) LL-PAIDEIA
medicamentum|medicāmentum, -ī, n., drug, remedy, medicine (19) LL-PAIDEIA
medicina|medicīna, -ae, f., art or practice of medicine (24) LL-PAIDEIA
medico|medicō, medicāre, medicāvī, medicātus, medicate (27) LL-PAIDEIA
medicus|medicus, -ī, m., doctor, physician (19) LL-PAIDEIA
medius|medius, -a, -um, adj., middle, middle of (14) LL-PAIDEIA
mel|mel, mellis, n., honey (27) LL-PAIDEIA
membrum|membrum, -ī, n., limb, section (15) LL-PAIDEIA
memini|meminī, meminisse, —, remember, call to mind (+ gen.) (26) LL-PAIDEIA
memoria|memoria, -ae, f., memory, recollection; memoria tenēre, to remember (24) LL-PAIDEIA
memoro|memorō, memorāre, memorāvī, memorātus, remember, be mindful of (20) LL-PAIDEIA
mens|mēns, mentis, f., mind, reason (16) LL-PAIDEIA
mensa|mēnsa, -ae, f., table; mēnsa scrīptōria, desk, writing table (14) LL-PAIDEIA
mercator|mercātor, mercātōris, m., trader, merchant (13) LL-PAIDEIA
meridies|merīdiēs, merīdiēī, m., noon, midday, south (20) LL-PAIDEIA
meridio|merīdiō, merīdiāre, merīdiāvī, merīdiātus, take a midday siesta (20) LL-PAIDEIA
metropolitanus|mētropolītānus, -a, -um, adj., metropolitan (23) LL-PAIDEIA
meus|meus, -a, -um, adj., my, mine, of me, belonging to me (6) LL-PAIDEIA
microphonium|microphonium, -iī, n., microphone (29) LL-PAIDEIA
miles|miles, militis, m., soldier (17) LL-PAIDEIA
mille|mille, num., thousand (17) LL-PAIDEIA
minister|minister, ministrī, m., attendant, waiter; agent, aide (12) LL-PAIDEIA
ministro|ministrō, ministrāre, ministrāvī, ministrātus, attend (to), serve, furnish, supply (+ dat.) (18) LL-PAIDEIA
ministra|ministra, -ae, f., attendant, waiter (18) LL-PAIDEIA
mirabilis|mīrābilis, mīrābile, adj., wonderful, marvelous, astonishing, extraordinary; mīrābile vīsū, wonderful to behold (14) LL-PAIDEIA
miror|mīror, mīrārī, mīrātus sum, admire; wonder, marvel at (18) LL-PAIDEIA
mirus|mīrus, -a, -um, adj., wonderful, amazing (26) LL-PAIDEIA
misceo|misceō, miscēre, miscuī, mixtus, mix, stir up (27) LL-PAIDEIA
miser|miser, misera, miserum, adj., poor, miserable, unfortunate, unhappy (8) LL-PAIDEIA
misere|miserē, adv., wretchedly, unhappily, unfortunately (14) LL-PAIDEIA
misereor|misereor, miserērī, miseritus sum, pity, feel sorry for (+ gen.); miseret, impers., it pities (with gen. of thing causing one to feel sorry) (21) LL-PAIDEIA
misereo|misereor, miserērī, miseritus sum, pity, feel sorry for (+ gen.); miseret, impers., it pities (with gen. of thing causing one to feel sorry) (21) LL-PAIDEIA
mitto|mittō, mittere, mīsī, missus send (11) LL-PAIDEIA
modernus|modernus, -a, -um, adj., modern (20) LL-PAIDEIA
modestus|modestus, -a, -um, adj., modest, mild (23) LL-PAIDEIA
modo|modo, adv., only, merely (15) LL-PAIDEIA
modus|modus, -ī, m., manner, way; method, fashion (15) LL-PAIDEIA
moenia|moenia, moenium, n. pl., town walls (23) LL-PAIDEIA
moene|moenia, moenium, n. pl., town walls (23) LL-PAIDEIA
moles|mōlēs, mōlis, f., large mass, heap, pile; large structure (23) LL-PAIDEIA
molesto|molestō, molestāre, molestāvī, molestātus, bother, disturb, annoy (21) LL-PAIDEIA
momentum|mōmentum, -ī, n., moment, instant; magnī/maximī mōmentī, of great importance, of the highest importance (17) LL-PAIDEIA
monachus|monachus, -ī, m., monk (22) LL-PAIDEIA
moneo|moneō, monēre, monuī, monitus, remind, advise, warn (25) LL-PAIDEIA
mons|mōns, montis, m., mountain, mount (14) LL-PAIDEIA
monstro|mōnstrō, mōnstrāre, mōnstrāvī, mōnstrātus, show, point out (20) LL-PAIDEIA
monumentum|monumentum, -ī, n., reminder, memorial, monument, record (25) LL-PAIDEIA
mora|mora, -ae, n., delay, pause (15) LL-PAIDEIA
mordeo|mordeō, mordēre, momordī, morsus, bite (15) LL-PAIDEIA
morior|morior, morī, mortuus sum, die, pass away (15) LL-PAIDEIA
mortuus|mortuus, -a, -um, adj., dead (15) LL-PAIDEIA
mors|mors, mortis, f., death (15) LL-PAIDEIA
mos|mōs, mōris, f., custom, habit, norm; morals (pl.) (10) LL-PAIDEIA
moveo|moveō, movēre, mōvī, mōtus, move, stir (15) LL-PAIDEIA
mox|mox, adv., soon, next (11) LL-PAIDEIA
mugio|mūgiō, mūgīre, mūgīvī, mūgītus, moo, bellow (23) LL-PAIDEIA
mulceo|mulceō, mulcēre, mulsī, mulsus, pet, stroke, touch lightly (21) LL-PAIDEIA
multitudo|multitūdō, multitūdinis, f., multitude, great number, crowd (16) LL-PAIDEIA
multum|multum, comp. plūs, superl. plūrimum, adv., much, greatly, plenty, very; more; most (15) LL-PAIDEIA
multus|multus, -a, -um, adj., much, many (4) LL-PAIDEIA
mundanus|mundānus, -a, -um, adj., worldly, of this world (26) LL-PAIDEIA
mundus|mundus, -ī, m., world (26) LL-PAIDEIA
mundus|mundus, -a, -um, adj., clean, tidy (27) LL-PAIDEIA
murus|mūrus, -ī, m., wall (21) LL-PAIDEIA
mus|mūs, mūris, m./f., mouse (23) LL-PAIDEIA
musa|mūsa, -ae, f., muse (one of the goddesses of poetry, music, etc.) (26) LL-PAIDEIA
musica|musica, -ae, f., music (24) LL-PAIDEIA
musicus|mūsicus, -ī, m., musician (26) LL-PAIDEIA
mustela|mustēla, -ae, f., weasel (23) LL-PAIDEIA
muto|mūtō, mūtāre, mūtāvī, mūtātus, change, alter (14) LL-PAIDEIA
mysterium|mystērium, -iī, n., mystery, secret religious rite (27) LL-PAIDEIA
mythologicus|mȳthologicus, -a, -um, adj., mythological, of mythology (15) LL-PAIDEIA
nam|nam, conj., for (11) LL-PAIDEIA
narro|nārrō, nārrāre, nārrāvī, nārrātus, tell (a story), relate, recount (16) LL-PAIDEIA
nascor|nāscor, nāscī, nātus sum, be born (2) LL-PAIDEIA
nasus|nāsus, -ī, m., nose (18) LL-PAIDEIA
nativitas|nātīvitās, nātīvitātis, f., birth (13) LL-PAIDEIA
navalis|nāvālis, nāvāle, adj., naval, of ships (24) LL-PAIDEIA
navicula|nāvicula, -ae, f., small ship (26) LL-PAIDEIA
navigo|nāvigō, nāvigāre, nāvigāvī, nāvigātus, sail, navigate (26) LL-PAIDEIA
navis|nāvis, nāvis, f., ship (18) LL-PAIDEIA
ne|nē, adv., no, not; nē… quidem, not even (17) LL-PAIDEIA
ne|nē, conj., lest, so that… not (28) LL-PAIDEIA
ne|-ne, part., added at the end of a word to make a question (1) LL-PAIDEIA
nec|nec, conj., and not, nor; nec...nec, neither...nor; nec sōlum…sed etiam, not only...but also (3) LL-PAIDEIA
necessarius|necessārius, -a, -um, adj., necessary (13) LL-PAIDEIA
necesse|necesse, indecl. adj., necessary (13) LL-PAIDEIA
necnon|necnōn, adv., and also (18) LL-PAIDEIA
nectar|nectar, nectaris, n. nectar, the drink of the gods; anything sweet, pleasant or delicious (13) LL-PAIDEIA
nego|negō, negāre, negāvī, negātus, deny, refuse; say not (22) LL-PAIDEIA
negotiosus|negōtiōsus, -a, -um, adj., active, occupied, busy (18) LL-PAIDEIA
nemo|nēmō, nēminis, pron., nobody, no one (12) LL-PAIDEIA
nemoralis|nemorālis, nemorāle, adj., belonging to the forest, sylvan (18) LL-PAIDEIA
nempe|nempe, conj., truly, certainly, of course (22) LL-PAIDEIA
nepos|nepōs, nepōtis, m./f., grandson, granddaughter; descendant (16) LL-PAIDEIA
neque|neque, conj., and not, nor; neque…neque, neither…nor (16) LL-PAIDEIA
nescio|nesciō, nescīre, nescīvī, nescītus, not know (15) LL-PAIDEIA
neuter|neuter, neutra, neutrum, adj., neither (of two); neuter (grammatical gender) (1) LL-PAIDEIA
niger|niger, nigra, nigrum, adj., black, dark (25) LL-PAIDEIA
nihil|nihil, indecl., nothing (10) LL-PAIDEIA
nil|nīl, indecl., alternate form of nihil (26) LL-PAIDEIA
nimis|nimis, adv., very much; too much; exceedingly (14) LL-PAIDEIA
nisi|nisi, conj., if not; unless, except (14) LL-PAIDEIA
nitor|nītor, nītī, nīsus sum, press, lean upon (+ abl.) (21) LL-PAIDEIA
nivarius|nivārius, -a, -um, adj., snowy (17) LL-PAIDEIA
niveus|niveus, -a, -um, adj., snowy (26) LL-PAIDEIA
nix|nix, nivis, f., snow (26) LL-PAIDEIA
noctiluca|noctilūca, -ae, f., moon (26) LL-PAIDEIA
nolo|nōlō, nōlle, nōluī, —, be unwilling, not want to, refuse to (21) LL-PAIDEIA
nomen|nōmen, nōminis, n., name, family name; noun (2) LL-PAIDEIA
nomino|nōminō, nōmināre, nōmināvī, nōminātus, name, call (14) LL-PAIDEIA
non|nōn, adv., no, not (1) LL-PAIDEIA
nondum|nōndum, adv., not yet (1) LL-PAIDEIA
nonnullus|nōnnullus, -a, -um, adj., some (18) LL-PAIDEIA
nonnumquam|nōnnumquam, adv., sometimes (23) LL-PAIDEIA
nos|nōs, pron., we, us (3) LL-PAIDEIA
noster|noster, nostra, nostrum, adj., our (9) LL-PAIDEIA
notus|nōtus, -a, -um, adj., well-known, familiar; notable, famous (13) LL-PAIDEIA
novem|novem, num., nine (1) LL-PAIDEIA
novus|novus, -a, -um, adj., new, fresh, young; unusual, extraordinary (4) LL-PAIDEIA
nox|nox, noctis, f., night (17) LL-PAIDEIA
nugae|nūgae, -ārum, f. pl., trifles, nonsense, frivolities (23) LL-PAIDEIA
nugator|nūgātor, nūgātōris, m., joker, silly person; someone who plays the fool, tells tall tales (13) LL-PAIDEIA
nullus|nūllus, -a, -um, adj., no, none; nobody, no one (13) LL-PAIDEIA
num|num, adv., if, whether; surely not (in a question expecting a negative answer) (13) LL-PAIDEIA
numero|numerō, numerāre, numerāvī, numerātus, count, add up; reckon; number someone or something among (4) LL-PAIDEIA
numerus|numerus, -ī, m., number (1) LL-PAIDEIA
nummus|nummus, -ī, m., coin; cash, money (13) LL-PAIDEIA
numquam|numquam, adv., never (12) LL-PAIDEIA
nunc|nunc, adv., now, today, at present (3) LL-PAIDEIA
nuntium|nūntium, -iī, n., message, announcement; news; nūntium ēlectrōnicum: email (27) LL-PAIDEIA
nympha|nympha, -ae, f., nymph (semi-divine female spirit) (23) LL-PAIDEIA
ob|ob, prep. with acc., on account of, for the sake of; quam ob rem, why, for what reason (14) LL-PAIDEIA
obeo|obeō, obīre, obiī/obīvī, obitus, die (23) LL-PAIDEIA
obicio|obiciō, obicere, obiēcī, obiectus, throw to, cast before (27) LL-PAIDEIA
obliviscor|oblīvīscor, oblīvīscī, oblītus sum, forget (+ gen.) (29) LL-PAIDEIA
obscurus|obscūrus, -a, -um, adj., dim, dark, obscure, shadowy (25) LL-PAIDEIA
observo|observō, observāre, observāvī, observātus, watch, observe, heed (24) LL-PAIDEIA
occido|occidō, occidere, occidī, occāsus, fall, set (of the sun) (21) LL-PAIDEIA
ocellus|ocellus, -ī, m., little eye, darling, sweetheart (17) LL-PAIDEIA
octo|octō, num., eight (1) LL-PAIDEIA
oculus|oculus, -ī, m., eye (16) LL-PAIDEIA
odi|ōdī, ōdisse, only perf., hate, dislike (15) LL-PAIDEIA
odiosus|odiōsus, -a, -um, adj., hateful, disagreeable (18) LL-PAIDEIA
odor|odor, odōris, m., scent, odor, smell (14) LL-PAIDEIA
offa|offa, -ae, f., piece, lump of food; cake (27) LL-PAIDEIA
offero|offerō, offerre, obtulī, oblātus, offer, present; bestow (27) LL-PAIDEIA
oleo|oleō, olēre, oluī, —, smell of, smell like something (29) LL-PAIDEIA
olim|ōlim, adv., formerly; once, once upon a time; in the future (19) LL-PAIDEIA
oliva|olīva, -ae, f., olive, olive tree (13) LL-PAIDEIA
olor|olor, olōris, m., swan (18) LL-PAIDEIA
omen|ōmen, ōminis, n., sign, omen (29) LL-PAIDEIA
omnino|omnīnō, adv., entirely, altogether (24) LL-PAIDEIA
omnis|omnis, omne, adj., each, every (sing.); all (pl.) (1) LL-PAIDEIA
opinor|opīnor, opīnārī, opīnātus sum, suppose, imagine; think, judge (22) LL-PAIDEIA
oportet|oportet, oportēre, oportuit, —, it is necessary; ought, must (22) LL-PAIDEIA
oppidum|oppidum, -ī, town (4) LL-PAIDEIA
opus|opus, operis, n., work, need; opus est, there is need of (+ abl.) (15) LL-PAIDEIA
ora|ōra, -ae, f., edge, limit (29) LL-PAIDEIA
oratio|ōrātiō, ōrātiōnis, f., speech, oration (16) LL-PAIDEIA
orator|ōrātor, ōrātōris, m., speaker, orator (7) LL-PAIDEIA
orbis|orbis, orbis, m., circle; orbis terrārum, world (17) LL-PAIDEIA
ordino|ōrdinō, ōrdināre, ōrdināvī, ōrdinātus, order, arrange, set in order (27) LL-PAIDEIA
origo|orīgō, orīginis, f., origin, source (24) LL-PAIDEIA
orior|orior, orīrī, ortus sum, rise, arise (esp. of the sun) (20) LL-PAIDEIA
ortus|ortus, -ūs, m., rising, sunrise (20) LL-PAIDEIA
ornithologicus|ornithologīcus, -a, -um, adj., ornithological; related to birds (15) LL-PAIDEIA
orno|ōrnō, ōrnāre, ōrnāvī, ōrnātus, equip, decorate, furnish, adorn (27) LL-PAIDEIA
os|ōs, ōris, n., mouth; expression, face (14) LL-PAIDEIA
os|os, ossis, n., bone (18) LL-PAIDEIA
osculor|ōsculor, ōsculārī, ōsculātus sum, kiss (26) LL-PAIDEIA
osculum|ōsculum, -ī, n., kiss (18) LL-PAIDEIA
ostendo|ostendō, ostendere, ostendī, ostentus, show; reveal; display, exhibit (30) LL-PAIDEIA
otiosus|ōtiōsus, -a, -um, adj., idle; unemployed, unoccupied, at leisure (18) LL-PAIDEIA
ovis|ovis, ovis, f., sheep (23) LL-PAIDEIA
ovum|ōvum, -ī, n., egg (17) LL-PAIDEIA
paedagogus|paedagōgus, -ī, m., pedagogue, slave who accompanied children to school (16) LL-PAIDEIA
paene|paene, adv., nearly, almost (17) LL-PAIDEIA
paenitet|paenitet, paenitēre, paenituit, —, impers., it causes one to repent, it grieves one; to be sorry (16) LL-PAIDEIA
pagina|pāgina, -ae, f., page, sheet (27) LL-PAIDEIA
palleo|palleō, pallēre, palluī, —, be or look pale; become pale (15) LL-PAIDEIA
pallium|pallium, -iī, n., cover, coverlet; a kind of Greek cloak (25) LL-PAIDEIA
palma|palma, -ae, f., palm tree, branch (24) LL-PAIDEIA
pando|pandō, pandere, pandī, passus, spread out (28) LL-PAIDEIA
panis|pānis, pānis, m., bread, loaf (13) LL-PAIDEIA
Pantheum|Pantheum, -ī, n., Pantheon (11) LL-PAIDEIA
Papa|Pāpa, -ae, m., the Pope (19) LL-PAIDEIA
parens|parēns, parentis, m/f., parent; father, mother (9) LL-PAIDEIA
paries|pariēs, parietis, m., wall, house wall (22) LL-PAIDEIA
paro|parō, parāre, parāvī, parātus, prepare; furnish, supply (20) LL-PAIDEIA
pars|pars, partis, f., part, region; portion, piece (16) LL-PAIDEIA
parvulus|parvulus, -a, -um, adj., very small, very young (25) LL-PAIDEIA
parvus|parvus, -a, -um, comp. minor, superl. minimus, adj., small, little; superl. smallest, least (4) LL-PAIDEIA
pascor|pāscor, pāscī, pāstus sum feed, feed on; graze (18) LL-PAIDEIA
pasco|pāscor, pāscī, pāstus sum feed, feed on; graze (18) LL-PAIDEIA
pastor|pāstor, pāstōris, m., shepherd, herdsman (23) LL-PAIDEIA
patella|patella, -ae, f., small dish, plate (20) LL-PAIDEIA
pateo|pateō, patēre, patuī, —, be open, lie open, be accessible (24) LL-PAIDEIA
pater|pater, patris, m., father (9) LL-PAIDEIA
patientia|patientia, -ae, f., endurance, patience (10) LL-PAIDEIA
patior|patior, patī, passus sum, suffer, endure (27) LL-PAIDEIA
patria|patria, -ae, f., native land, country (23) LL-PAIDEIA
patronus|patrōnus, -ī, m., patron, advocate, protector (16) LL-PAIDEIA
patruus|patruus, -ī, m., paternal uncle; uncle on one’s father’s side (24) LL-PAIDEIA
pauci|paucī, -ae, -a, adj. pl., a few, a small number of (4) LL-PAIDEIA
paulatim|paulātim, adv., little by little, gradually (26) LL-PAIDEIA
paulo|paulō, adv., by a little, a little, somewhat (20) LL-PAIDEIA
paulum|paulum, adv., little, a little (18) LL-PAIDEIA
pauper|pauper, pauperis, m., poor man (20) LL-PAIDEIA
paupertas|paupertās, paupertātis, f., poverty, need (21) LL-PAIDEIA
pavimentum|pavīmentum, -ī, n., pavement, floor (6) LL-PAIDEIA
pavo|pāvō, pāvōnis, m., peacock (17) LL-PAIDEIA
pax|pāx, pācis, f., peace, harmony (12) LL-PAIDEIA
pecto|pectō, pectere, pexī, pexus, comb (21) LL-PAIDEIA
pectus|pectus, pectoris, n., breast, chest (21) LL-PAIDEIA
pecunia|pecūnia, -ae, f., money (13) LL-PAIDEIA
pecuniosus|pecūniōsus, -a, -um, adj., rich, wealthy (16) LL-PAIDEIA
pedeplanum|pedeplānum, -ī, n., ground floor (27) LL-PAIDEIA
pegma|pēgma, pēgmatis, n., bookcase, bookshelf (27) LL-PAIDEIA
pendeo|pendeō, pendēre, pependī, —, hang down from; be suspended (25) LL-PAIDEIA
per|per, prep. with acc., through, during (6) LL-PAIDEIA
peregrinator|peregrīnātor, peregrīnātōris, m., traveler (21) LL-PAIDEIA
pereo|pereō, perīre, perīvī/periī, peritus, die, pass away, perish (25) LL-PAIDEIA
perfidus|perfidus, -a, -um, adj., faithless, treacherous; false, deceitful (18) LL-PAIDEIA
pergo|pergō, pergere, perrēxī, perrēctus, go on, proceed; continue (14) LL-PAIDEIA
perimo|perimō, perimere, perēmī, perēmptus, kill, destroy (15) LL-PAIDEIA
peritus|perītus, -a, -um, adj., skilled, skillful; experienced, expert (+ gen.) (18) LL-PAIDEIA
perna|perna, -ae, f., ham (29) LL-PAIDEIA
perpetuus|perpetuus, -a, -um, adj., continuous, perpetual, everlasting (16) LL-PAIDEIA
perpulcher|perpulcher, perpulchra, perpulchrum, adj., very beautiful; very much right, correct (22) LL-PAIDEIA
persequor|persequor, persequī, persecūtus sum, follow, follow up, pursue (23) LL-PAIDEIA
persona|persōna, -ae, f., mask, character (27) LL-PAIDEIA
pertineo|pertineō, pertinēre, pertinuī, pertentus, relate to, concern, pertain to (30) LL-PAIDEIA
pervenio|perveniō, pervenīre, pervēnī, perventus, come to, reach, arrive (30) LL-PAIDEIA
pes|pēs, pedis, m., foot (17) LL-PAIDEIA
pessimus|pessimus, -a, -um, superl. adj., worst (superlative of malus) (16) LL-PAIDEIA
peto|petō, petere, petīvī, petītus, aim at, beg, entreat, ask for (16) LL-PAIDEIA
phoenix|phoenīx, phoenīcis, m., phoenix (18) LL-PAIDEIA
photographicus|photographicus, -a, -um, adj., photographic (11) LL-PAIDEIA
pictor|pictor, pictōris, m., painter (19) LL-PAIDEIA
pictura|pictūra, -ae, f., picture, painting (11) LL-PAIDEIA
pietas|pietās, pietātis, f., piety, loyalty (24) LL-PAIDEIA
piget|piget, pigēre, piguit, —, impers., it grieves, it disgusts; to dislike, loathe (21) LL-PAIDEIA
pingo|pingō, pingere, pīnxī, pictus, paint, color; depict (15) LL-PAIDEIA
pinguis|pinguis, pingue, adj., fat, thick (25) LL-PAIDEIA
pinna|pinna, -ae, f., feather, wing (18) LL-PAIDEIA
pinus|pīnus, -ūs, f., pine, fir tree (23) LL-PAIDEIA
pipio|pīpiō, pīpiāre, pīpiāvī, pīpiātus, chirp (8) LL-PAIDEIA
piscis|piscis, piscis, m., fish (17) LL-PAIDEIA
pistor|pistor, pistōris, m., miller, baker (19) LL-PAIDEIA
pistrinum|pistrīnum, -ī, n., mill, bakery (19) LL-PAIDEIA
pistrix|pistrix, pistricis, f., sea monster, shark (29) LL-PAIDEIA
pius|pius, -a, um, adj., upright, faithful; dutiful, respectful; righteous, good (16) LL-PAIDEIA
placenta|placenta, -ae, f., cake, a kind of flat cake; pizza (20) LL-PAIDEIA
placet|placet, placēre, placuit, placitus, impers., it is pleasing, one likes (+ dat.) (11) LL-PAIDEIA
placidus|placidus, -a, -um, adj., gentle, calm, mild; peaceful, placid (18) LL-PAIDEIA
plane|plānē, adv., clearly, plainly (22) LL-PAIDEIA
planus|plānus, -a, -um, adj., plain, clear, obvious (23) LL-PAIDEIA
platea|platēa, -ae, f., broad way, street (28) LL-PAIDEIA
plenus|plēnus, -a, -um, adj., full (20) LL-PAIDEIA
plico|plicō, plicāre, plicāvī, plicātus, fold (27) LL-PAIDEIA
pluma|plūma, -ae, f., feather, plume (15) LL-PAIDEIA
plurimus|plūrimus, -a, -um, adj., most, greatest number or amount; very many (16) LL-PAIDEIA
plus|plūs,  gen. plūris, adj., more, several (comparative of multus) (15) LL-PAIDEIA
pluvia|pluvia, -ae, f., rain (23) LL-PAIDEIA
poculum|pōculum, -ī, n., cup, bowl, drinking vessel; drink (18) LL-PAIDEIA
poena|poena, -ae, f., penalty, punishment; poenās dāre, pay a penalty (24) LL-PAIDEIA
poeta|poēta, -ae, m., poet (11) LL-PAIDEIA
poeticus|poēticus, -a, -um, adj., poetic (27) LL-PAIDEIA
polliceor|polliceor, pollicērī, pollicitus sum, promise (18) LL-PAIDEIA
pono|pōnō, pōnere, posuī, positus, put, place, set; set up (15) LL-PAIDEIA
pons|pōns, pontis, m., bridge (27) LL-PAIDEIA
pontifex|pontifex, pontificis, m., high priest, pontiff; pontifex maximus, pope (19) LL-PAIDEIA
populus|populus, -ī, m., people, public, populace (22) LL-PAIDEIA
porro|porrō, adv., further on, onward (26) LL-PAIDEIA
porta|porta, -ae, f., door, gate, entrance (15) LL-PAIDEIA
portentum|portentum, -ī, n., sign, omen (29) LL-PAIDEIA
porticus|porticus, -ūs, f., colonnade, covered walk; portico (23) LL-PAIDEIA
porto|portō, portāre, portāvī, portātus, carry, bring (19) LL-PAIDEIA
possum|possum, posse, potuī, —, be able to, can (12) LL-PAIDEIA
post|post, prep. with acc., behind, after (13)  LL-PAIDEIA
post|post, adv., behind, afterwards (16) LL-PAIDEIA
postea|posteā, adv., afterwards; next, then (21) LL-PAIDEIA
postis|postis, postis, m., doorpost (24) LL-PAIDEIA
postquam|postquam, conj., after (16) LL-PAIDEIA
postremo|postrēmō, adv., finally, at last (18) LL-PAIDEIA
postridie|postrīdiē, adv., on the following day (25) LL-PAIDEIA
potens|potēns, gen. potentis, adj., powerful, strong, mighty, capable (26) LL-PAIDEIA
potius|potius, adv., instead, rather (30) LL-PAIDEIA
potor|pōtor, pōtōris, m., drinker (29) LL-PAIDEIA
praecipue|praecipuē, adv., especially; primarily, chiefly (17) LL-PAIDEIA
praeda|praeda, -ae, f., booty, loot, spoils (27) LL-PAIDEIA
praesens|praesēns, gen. praesentis, adj., present; at hand (24) LL-PAIDEIA
praesidium|praesidium, -iī, n., protection, help, guard; garrison (28) LL-PAIDEIA
praeter|praeter, prep. with acc., besides, except for; past, by (18) LL-PAIDEIA
praetereo|praetereō, praeterīre, praeterīvī/praeteriī, praeteritus, pass, go by (23) LL-PAIDEIA
prandeo|prandeō, prandēre, prandī, prānsus, have lunch (21) LL-PAIDEIA
prandium|prandium, -iī, n., lunch (15) LL-PAIDEIA
precor|precor, precārī, precātus sum, beg, implore, entreat, pray (24) LL-PAIDEIA
premo|premō, premere, pressī, pressus, press (29) LL-PAIDEIA
pretiosus|pretiōsus, -a, -um, adj., expensive, costly; of great value, precious (25) LL-PAIDEIA
pretium|pretium, -iī, n., price; value, worth (13) LL-PAIDEIA
prex|prex, precis, f., prayer, request (16) LL-PAIDEIA
primarius|prīmārius, -a, -um, adj., primary (2) LL-PAIDEIA
primum|prīmum, adv., at first, in the first place (14) LL-PAIDEIA
primus|prīmus, -a, -um, adj., first (1) LL-PAIDEIA
princeps|prīnceps, prīncipis, m., first citizen; non-military title of Roman Emperor (23) LL-PAIDEIA
priusquam|priusquam, conj., before; until, sooner than (21) LL-PAIDEIA
pro|prō, prep. with abl., on behalf of; before; in front of; instead of; for, in exchange for (13) LL-PAIDEIA
probo|probō, probāre, probāvī, probātus, approve of, commend; prove, examine, test, try out (18) LL-PAIDEIA
procedo|prōcēdō, prōcēdere, prōcessī, prōcessus, proceed, advance; go on (29) LL-PAIDEIA
procul|procul, adv., far off, far away; distant (11) LL-PAIDEIA
proelium|proelium, -iī, n., battle, fight (24) LL-PAIDEIA
profecto|profectō, adv., actually, really, indeed (29) LL-PAIDEIA
profero|prōferō, prōferre, prōtulī, prōlātus, bring forward, mention (30) LL-PAIDEIA
proficiscor|proficīscor, proficīscī, profectus sum, depart, set out; proceed (20) LL-PAIDEIA
profugus|profugus, -a, -um, adj., fugitive, exiled; fleeing (24) LL-PAIDEIA
progenies|prōgeniēs, prōgeniēī, f., race, family; progeny (25) LL-PAIDEIA
progredior|prōgredior, prōgredī, prōgressus sum, go, come forth; go forward, proceed (27) LL-PAIDEIA
prope|prope, prep. with acc., near, close to; adv., near, close by, almost (14) LL-PAIDEIA
propino|propīnō, propīnāre, propīnāvī, propīnātus, drink to someone’s health, toast (29) LL-PAIDEIA
propinquus|propinquus, -a, -um, adj., near, nearby; neighboring (24) LL-PAIDEIA
propositum|prōpositum, -ī, n., proposal, suggestion (20) LL-PAIDEIA
propter|propter, prep. with acc., on account of, because of (21) LL-PAIDEIA
prospecto|prōspectō, prōspectāre, prōspectāvī, prōspectātum, look, gaze out at; view (14) LL-PAIDEIA
prospectus|prōspectus, -ūs, m., view, prospect; panorama (24) LL-PAIDEIA
prosum|prōsum, prōdesse, prōfuī, prōfutūrus, be useful, advantageous; benefit (+ dat.); prōsit, a toast when drinking to another’s health; cheers (29) LL-PAIDEIA
protego|prōtegō, prōtegere, prōtēxī, prōtēctus, cover, protect (27) LL-PAIDEIA
proximus|proximus, -a, um, adj., nearest, closest; next (18) LL-PAIDEIA
psittacus|psittacus, -ī, m., parrot (8) LL-PAIDEIA
publicus|pūblicus, -a, -um, adj., public, of the people or state; rēs pūblica, republic (19) LL-PAIDEIA
pudet|pudet, pudēre, puduit, impers., it shames; to be ashamed (21) LL-PAIDEIA
pudor|pudor, pudōris, m., shame (21) LL-PAIDEIA
puella|puella, -ae, f., girl (1) LL-PAIDEIA
puer|puer, -ī, m., boy (1) LL-PAIDEIA
pugna|pugna, -ae, f., fight, battle (17) LL-PAIDEIA
pugno|pugnō, pugnāre, pugnāvī, pugnātus, fight (16) LL-PAIDEIA
pulcher|pulcher, pulchra, pulchrum, superl. pulcherrimus, adj. beautiful (11) LL-PAIDEIA
pulso|pulsō, pulsāre, pulsāvī, pulsātus, strike, hit, beat (15) LL-PAIDEIA
pulvis|pulvis, pulveris, m., dust (24) LL-PAIDEIA
purgamentum|pūrgāmentum, -ī, n., filth, dirt (21) LL-PAIDEIA
purgo|pūrgō, pūrgāre, pūrgāvī, pūrgātus, clean, cleanse, purify (21) LL-PAIDEIA
purus|pūrus, -a, -um, adj., pure, clean (26) LL-PAIDEIA
puto|putō, putāre, putāvī, putātus, think (16) LL-PAIDEIA
qua|quā, adv., where, in which place (24) LL-PAIDEIA
quadratus|quadrātus, -a, -um, adj., square (24) LL-PAIDEIA
quaero|quaerō, quaerere, quaesīvī, quaesītus, ask, inquire, seek (22) LL-PAIDEIA
quaeso|quaesō, please (10) LL-PAIDEIA
qualis|quālis, quāle, adj., what kind of, what sort of (20) LL-PAIDEIA
quam|quam, adv., how, how much; as, than; quam + superlative, as... as possible (12) LL-PAIDEIA
quamquam|quamquam, conj., although (14) LL-PAIDEIA
quando|quandō, adv., when (19) LL-PAIDEIA
quantus|quantus, -a, -um, adj., how great, how much (13) LL-PAIDEIA
quare|quārē, adv., why, wherefore (15) LL-PAIDEIA
quasi|quasi, adv., as if, just as (25) LL-PAIDEIA
quattuor|quattuor, num., four (1) LL-PAIDEIA
quattuordecim|quattuordecim, num., fourteen (13) LL-PAIDEIA
que|-que, conj., and (8) LL-PAIDEIA
quercus|quercus, -ūs, f., oak tree (26) LL-PAIDEIA
queror|queror, querī, questus sum, complain, lament (21) LL-PAIDEIA
qui|quī, quae, quod, interr. adj., who? what? which? (7) LL-PAIDEIA
qui|quī, quae, quod, rel. pron., who, which; interr. adj., who? what? which? (12) LL-PAIDEIA
quia|quia, conj., because, since (6) LL-PAIDEIA
quis|quis, quid, interr. pron., who? what? (1) LL-PAIDEIA
quies|quiēs, quiētis, f., rest, quiet, sleep (12) LL-PAIDEIA
quiesco|quiēscō, quiēscere, quiēvī, quiētus, to rest, be quiet, sleep (15) LL-PAIDEIA
quietus|quiētus, -a, -um, adj., quiet, silent (12) LL-PAIDEIA
quinque|quīnque, num., five (1) LL-PAIDEIA
quisquis|quisquis, quaequae, quidquid, interr. adj./pron., whoever, whichever (22) LL-PAIDEIA
quo|quō, adv., to where, whither (14) LL-PAIDEIA
quocumque|quōcumque, adv., to wherever, whithersoever (23) LL-PAIDEIA
quod|quod, conj., because, that (13) LL-PAIDEIA
quomodo|quōmodo, adv., in what manner, in what way, how (2) LL-PAIDEIA
quondam|quondam, adv., formerly, once (15) LL-PAIDEIA
quoniam|quoniam, conj., since (17) LL-PAIDEIA
quoque|quoque, conj., also, too (1) LL-PAIDEIA
quot|quot, indecl. adj., how many, as many (2) LL-PAIDEIA
radius|radius, -iī, m., ray of light (25) LL-PAIDEIA
rapidus|rapidus, -a, -um, adj., rapid, swift (17) LL-PAIDEIA
rapina|rapīna, -ae, f., robbery, theft (28) LL-PAIDEIA
rapio|rapiō, rapere, rapuī, raptus, snatch, grab, carry off (27) LL-PAIDEIA
rarus|rārus, -a, -um, adj., rare, uncommon (18) LL-PAIDEIA
raro|rārō, adv., seldom, infrequently; rarely (18) LL-PAIDEIA
ratio|ratiō, ratiōnis, f., account, reckoning (23) LL-PAIDEIA
ratiocinator|ratiōcinātor, ratiōcinātōris, m., accountant, bookkeeper (19) LL-PAIDEIA
recedo|recēdō, recēdere, recessī, recessus, retire, withdraw; pass, slip away (15) LL-PAIDEIA
recens|recēns, gen. recentis, adj., recent; fresh (29) LL-PAIDEIA
receptaculum|receptāculum, -ī, n., receptacle, container (21) LL-PAIDEIA
recipio|recipiō, recipere, recēpī, receptus, take back, receive (18) LL-PAIDEIA
recito|recitō, recitāre, recitāvī, recitātus, read aloud, recite (16) LL-PAIDEIA
recte|rēctē, adv., rightly, correctly; properly (9) LL-PAIDEIA
rectus|rēctus, -a, -um, adj., straight (25) LL-PAIDEIA
recumbo|recumbō, recumbere, recubuī, —, recline, recline at table; lie down (26) LL-PAIDEIA
reddo|reddō, reddere, reddidī, redditus, return, restore, give back (25) LL-PAIDEIA
redeo|redeō, redīre, redīvī/rediī, reditus, return, go back; come back (15) LL-PAIDEIA
reduco|redūcō, redūcere, redūxī, reductus, lead back, bring back (28) LL-PAIDEIA
refero|referō, referre, rettulī, relātus, bring back; rēfert, impers., it is of importance, it matters, it concerns (17) LL-PAIDEIA
regina|rēgīna, -ae, f., queen (17) LL-PAIDEIA
regio|regiō, regiōnis, f., region, province; area (26) LL-PAIDEIA
regius|rēgius, -a, -um, adj., royal, regal, kingly; Rēgia, -ae, f., a building in the Roman forum (24) LL-PAIDEIA
regno|rēgnō, rēgnāre, rēgnāvī, rēgnātus, rule, reign (17) LL-PAIDEIA
rego|regō, regere, rēxī, rēctus, rule; manage, direct (24) LL-PAIDEIA
regula|rēgula, -ae, f., rule, standard (22) LL-PAIDEIA
relaxo|relaxō, relaxāre, relaxāvī, relaxātus, loosen, slacken; relax (27) LL-PAIDEIA
religio|religiō, religiōnis, f., worship, religion (27) LL-PAIDEIA
relinquo|relinquō, relinquere, relīquī, relictus, leave behind, abandon (15) LL-PAIDEIA
remitto|remittō, remittere, remīsī, remissus, send back, throw back (26) LL-PAIDEIA
renascor|renāscor, renāscī, renātus sum, be born again, rise up again; aetās Renāscēns, f., the Renaissance (22) LL-PAIDEIA
repeto|repetō, repetere, repetīvī, repetītus, repeat (18) LL-PAIDEIA
requiesco|requiēscō, requiēscere, requiēvī, requiētus, quiet down; rest (15) LL-PAIDEIA
requiro|requīrō, requīrere, requīsīvī, requīsītus, seek, ask for; ask (15) LL-PAIDEIA
res|rēs, reī, f., thing; affair, matter (14) LL-PAIDEIA
resolvo|resolvō, resolvere, resolvī, resolūtus, loosen, release; relax (27) LL-PAIDEIA
resono|resonō, resonāre, resonāvī, resonātus, resound, ring out; echo (18) LL-PAIDEIA
respondeo|respondeō, respondēre, respondī, respōnsus, answer, respond (8) LL-PAIDEIA
resurgo|resurgō, resurgere, resurrēxī, resurrēctus, rise again, lift oneself up; be restored; revive (27) LL-PAIDEIA
rete|rēte, rētis, n., net (17) LL-PAIDEIA
retribuo|retribuō, retribuere, retribuī, retribūtus, hand back, recompense (30) LL-PAIDEIA
retro|retrō, adv., backwards, back; behind (18) LL-PAIDEIA
revenio|reveniō, revenīre, revēnī, reventus, come back, return (22) LL-PAIDEIA
rex|rēx, rēgis, m., king (6) LL-PAIDEIA
rhythmicus|rhythmicus, -a, -um, adj., rhythmic (29) LL-PAIDEIA
rideo|rīdeō, rīdēre, rīsī, rīsus, laugh; laugh at, ridicule; tease (3) LL-PAIDEIA
ridiculus|rīdiculus, -a, -um, adj., laughable, funny, amusing; silly, ridiculous (17) LL-PAIDEIA
rogo|rogō, rogāre, rogāvī, rogātus, ask, ask for (6) LL-PAIDEIA
roseus|roseus, -a, -um, adj., red; rose-colored (25) LL-PAIDEIA
rostrum|rōstrum, -ī, n., beak, ship’s prow; speaker’s platform in the Forum (19) LL-PAIDEIA
ruber|ruber, rubra, rubrum, adj., red, ruddy (14) LL-PAIDEIA
ruina|ruīna, -ae, f., ruin (24) LL-PAIDEIA
rus|rūs, rūris, n., farm; countryside (19) LL-PAIDEIA
Russicus|Russicus, -a, -um, adj., Russian (29) LL-PAIDEIA
rusticus|rūsticus, -a, -um, adj., country, rural; rustic (19) LL-PAIDEIA
sacculus|sacculus, -ī, m., little bag, purse (21) LL-PAIDEIA
saccus|saccus, -ī, m., sack, bag (27) LL-PAIDEIA
sacer|sacer, sacra, sacrum, adj., sacred, holy (12) LL-PAIDEIA
sacerdos|sacerdōs, sacerdōtis, m/f., priest, priestess (12) LL-PAIDEIA
sacrifico|sacrificō, sacrificāre, sacrificāvī, sacrificātus, sacrifice, make a sacrifice (12) LL-PAIDEIA
sacrficium|sacrficium, -iī, n., sacrifice (16) LL-PAIDEIA
saeculum|saeculum, -ī, n., century; age, time; in saecula, forever (24) LL-PAIDEIA
saepe|saepe, comp. saepius, superl. saepissimē, adv., often; frequently (11) LL-PAIDEIA
saepio|saepiō, saepīre, saepsī, saeptus, surround, encircle; hedge (25) LL-PAIDEIA
saevus|saevus, -a, -um, adj., harsh; savage, cruel (20) LL-PAIDEIA
sal|sāl, sālis, m., salt; wit (29) LL-PAIDEIA
salio|saliō, salīre, saluī, saltus, jump, leap over (20) LL-PAIDEIA
salsus|salsus, -a, -um, adj., salty, preserved in salt; witty, funny; male salsus, -a, -um, facetious, satirical (17) LL-PAIDEIA
saltatio|saltātiō, saltātiōnis, f., dance, dancing (29) LL-PAIDEIA
saltem|saltem, adv., at least, in any case (23) LL-PAIDEIA
salto|saltō, saltāre, saltāvī, saltātus, dance; jump (20) LL-PAIDEIA
salus|salūs, salūtis, f., health, prosperity, safety; good wish, greeting, salutation (11) LL-PAIDEIA
salutatio|salūtātiō, salūtātiōnis, f., greeting, salutation; formal morning call paid by client on patron (16) LL-PAIDEIA
saluto|salūtō, salūtāre, salūtāvī, salūtātus, greet, wish well; salute, hail (5) LL-PAIDEIA
salveo|salveō, salvēre, —, —, be well, be in good health; salvē, hello (2) LL-PAIDEIA
sanctus|sānctus, -a, -um, adj.,, sacred, venerable, holy (27) LL-PAIDEIA
sanguis|sanguis, sanguinis, m., blood (24) LL-PAIDEIA
sano|sānō, sānāre, sānāvī, sānātus, cure, heal (19) LL-PAIDEIA
sanus|sānus, -a, -um, adj., healthy (19) LL-PAIDEIA
sapidus|sapidus, -a, -um, adj., savoury; tasty (13) LL-PAIDEIA
sapiens|sapiēns, gen. sapientis, adj., wise, sensible; wise person, sage, philosopher (25) LL-PAIDEIA
sapienter|sapienter, adv., wisely, sensibly (29) LL-PAIDEIA
sapientia|sapientia, -ae, f., wisdom, understanding (24) LL-PAIDEIA
sapo|sāpō, sāpōnis, m., soap (27) LL-PAIDEIA
sarcophagus|sarcophagus, -ī, m., coffin, grave; sarcophagus (26) LL-PAIDEIA
satis|satis, indecl. adj., enough, sufficient; adv. enough, sufficiently (13) LL-PAIDEIA
saxum|saxum, -ī, n., rock, stone (24) LL-PAIDEIA
scala|scāla, -ae, f., flight of stairs, staircase (27) LL-PAIDEIA
scarabeus|scarabeus, -ī, m., beetle, scarab (29) LL-PAIDEIA
schola|schola, -ae, f., school (2) LL-PAIDEIA
scilicet|scīlicet, adv., one may know; evidently, certainly, of course (21) LL-PAIDEIA
scio|sciō, scīre, scīvī, scītus, know, understand (9) LL-PAIDEIA
scopa|scōpa, -ae, f., broom (21) LL-PAIDEIA
scribo|scrībō, scrībere, scrīpsī, scrīptus, write, compose (3) LL-PAIDEIA
scrinium|scrīnium, -iī, n., box, case; bookcase, book-box (22) LL-PAIDEIA
scriptor|scrīptor, scrīptōris, m., writer, author (7) LL-PAIDEIA
scriptorius|scrīptōrius, -a, -um, adj., writing, related to writing (27) LL-PAIDEIA
scrutor|scrūtor, scrūtārī, scrūtātus sum, examine, scrutinize; probe, investigate (28) LL-PAIDEIA
secundus|secundus, -a, -um, adj., second (1) LL-PAIDEIA
secundum|secundum, prep. with acc., according to, in line with (15) LL-PAIDEIA
securus|sēcūrus, -a, -um, adj., secure; untroubled, free from care (25) LL-PAIDEIA
sed|sed, conj., but, yet; however (1) LL-PAIDEIA
sedeo|sedeō, sedēre, sēdī, sessus, sit, remain; settle (10) LL-PAIDEIA
sella|sella, -ae, f., seat, stool; chair (18) LL-PAIDEIA
semiapertus|sēmiapertus, -a, -um, adj., half-open (27) LL-PAIDEIA
semisomnus|sēmisomnus, -a, -um, adj., half-asleep, drowsy (29) LL-PAIDEIA
semper|semper, adv., always (9) LL-PAIDEIA
senator|senātor, senātōris, m., senator (19) LL-PAIDEIA
senatus|senātus, -ūs, m., senate (19) LL-PAIDEIA
senex|senex, senis, m/f., old man, old woman (19) LL-PAIDEIA
senex|senex, gen. senis, adj., aged, old (19) LL-PAIDEIA
senilis|senīlis, senīle, adj., aged, old (19) LL-PAIDEIA
sententia|sententia, -ae, f., opinion, feeling; thought, meaning; sentence (22) LL-PAIDEIA
sentio|sentiō, sentīre, sēnsī, sēnsus, perceive, feel, sense; think, realize, see, understand (14) LL-PAIDEIA
sepelio|sepeliō, sepelīre, sepelīvī, sepultus, bury, inter (15) LL-PAIDEIA
septem|septem, num., seven (1) LL-PAIDEIA
sequor|sequor, sequī, secūtus sum, follow, accompany (17) LL-PAIDEIA
serenus|serēnus, -a, -um, adj., serene, tranquil; happy, cheerful (21) LL-PAIDEIA
serius|sērius, adv., later (29) LL-PAIDEIA
sero|sērō, adv., late, too late (21) LL-PAIDEIA
servo|servō, servāre, servāvī, servātus, watch over, protect, guard; save; store, keep, preserve (12) LL-PAIDEIA
servus|servus, -ī, m., slave (16) LL-PAIDEIA
severus|sevērus, -a, -um, adj., stern, strict; grave, austere; serious (8) LL-PAIDEIA
sex|sex, num., six (1) LL-PAIDEIA
si|sī, conj., if (4) LL-PAIDEIA
sic|sīc, adv., thus, so, in such a way, in this way (20) LL-PAIDEIA
sicco|siccō, siccāre, siccāvī, siccātus, dry, dry off exhaust (27) LL-PAIDEIA
sicut|sīcut, conj., as, just as; like, in the same way; as if (20) LL-PAIDEIA
sidus|sīdus, sīderis, n., group of stars, constellation (15) LL-PAIDEIA
significatio|significātiō, significātiōnis, f., signification, meaning (of a word) (25) LL-PAIDEIA
significo|significō, significāre, significāvī, significātus, signify, mean (21) LL-PAIDEIA
signum|signum, -ī, n., indication, sign; signal (13) LL-PAIDEIA
silentium|silentium, -iī, n., silence (22) LL-PAIDEIA
sileo|sileō, silēre, siluī, —, be silent, be quiet; not to speak (21) LL-PAIDEIA
silva|silva, -ae, f., wood, forest (26) LL-PAIDEIA
similis|similis, simile, superl. simillimus, adj., like, similar; resembling (19) LL-PAIDEIA
simul|simul, adv., at the same time, simultaneously; likewise, also (16) LL-PAIDEIA
Sina|Sīna, -ae, f., China (7) LL-PAIDEIA
sinum|Sīna, -ae, f., China (7) LL-PAIDEIA
sine|sine, prep. with abl., without  (12) LL-PAIDEIA
Sinensis|Sīnēnsis, Sīnēnse, adj., Chinese (7) LL-PAIDEIA
singulus|singulus, -a, -um, adj., single, individual; separate (30) LL-PAIDEIA
sinister|sinister, sinistra, sinistrum, adj., left (15) LL-PAIDEIA
sino|sinō, sinere, sīvī, situs, allow, permit, let (17) LL-PAIDEIA
sinus|sinus, -ūs, m., curved or bent surface; hollow, fold (27) LL-PAIDEIA
sisto|sistō, sistere, stitī, status, stop (15) LL-PAIDEIA
sitis|sitis, sitis, f., thirst; sitim habēre, be thirsty (18) LL-PAIDEIA
situs|situs, -a, -um, adj., located; situated, positioned (26) LL-PAIDEIA
situs|situs, -ūs, m., site, location; situation, position, site (23) LL-PAIDEIA
socius|socius, -iī, m., partner, ally; companion, comrade (20) LL-PAIDEIA
sodalis|sodālis, sodālis, m/f., companion, comrade,  mate; associate (21) LL-PAIDEIA
sol|sōl, sōlis, m., sun (12) LL-PAIDEIA
soleo|soleō, solēre, solitus sum, be in the habit of; be accustomed to (20) LL-PAIDEIA
sollicito|sollicitō, sollicitāre, sollicitāvī, sollicitātus, disturb, worry; stir up, agitate (21) LL-PAIDEIA
sollicitus|sollicitus, -a, -um, adj., concerned, worried; upset, troubled, anxious, apprehensive (18) LL-PAIDEIA
solum|sōlum, adv., only, just; alone (9) LL-PAIDEIA
solus|sōlus, -a, -um, adj., only, single; lonely, alone (17) LL-PAIDEIA
solvo|solvō, solvere, solvī, solūtus, fulfil, pay back (30) LL-PAIDEIA
somnio|somniō, somniāre, somniāvī, somniātus, dream; dream of or see in a dream (18) LL-PAIDEIA
somnium|somnium, -iī, n., dream, vision (18) LL-PAIDEIA
somnus|somnus, -ī, m., sleep (12) LL-PAIDEIA
sonitus|sonitus, -ūs, m., noise, loud sound (23) LL-PAIDEIA
sono|sonō, sonāre, sonuī, sonitus, make a noise, sound; accompany on a stringed instrument (19) LL-PAIDEIA
sonus|sonus, -ī, m., noise, sound (23) LL-PAIDEIA
sopio|sōpiō, sōpīre, sōpīvī, sōpītus, lull, cause to sleep (15) LL-PAIDEIA
soporificus|sopōrificus, -a, -um, adj., inducing sleep (27) LL-PAIDEIA
soporus|sopōrificus, -a, -um, adj., inducing sleep (27) LL-PAIDEIA
soporo|sopōrō, sopōrāre, sopōrāvī, sopōrātus, rend to sleep, render unconscious (27) LL-PAIDEIA
sordidus|sordidus, -a, -um, adj., dirty, filthy; unclean (21) LL-PAIDEIA
soror|soror, sorōris, f., sister (9) LL-PAIDEIA
spargo|spargō, spargere, sparsī, sparsus, scatter, strew; sprinkle about (28) LL-PAIDEIA
Spartanus|Spartānus, -a, -um, adj., Spartan (27) LL-PAIDEIA
specto|spectō, spectāre, spectāvī, spectātus, observe, watch, look at, see (9) LL-PAIDEIA
speculum|speculum, -ī, n., mirror, looking glass (25) LL-PAIDEIA
spero|spērō, spērāre, spērāvī, spērātus, hope, hope for (11) LL-PAIDEIA
splendeo|splendeō, splendēre, splenduī, —, shine, be bright, radiant (12) LL-PAIDEIA
spolio|spoliō, spoliāre, spoliāvī, spoliātus, rob, strip; plunder; deprive (+ abl.) (15) LL-PAIDEIA
spolium|spolium, -iī, n., spoils, booty (24) LL-PAIDEIA
spongia|spongia, -ae, f., sponge (27) LL-PAIDEIA
sportula|sportula, -ae, f., gift basket (28) LL-PAIDEIA
statim|statim, adv., immediately, at once (15) LL-PAIDEIA
stella|stēlla, -ae, f., star, planet; heavenly body (17) LL-PAIDEIA
stercus|stercus, stercoris, m., dung, manure; filth (23) LL-PAIDEIA
stilus|stilus, -ī, m., stylus, pencil (6) LL-PAIDEIA
sto|stō, stāre, stetī, status, stand, stand still; stō tēcum, etc., I agree with you (13) LL-PAIDEIA
stola|stola, -ae, f., stola, Roman women’s garment; dress, clothing (25) LL-PAIDEIA
stragulum|strāgulum, -ī, n., rug, carpet, mat; bedspread, bed-cover (27) LL-PAIDEIA
stramen|strāmen, strāminis, n., straw (24) LL-PAIDEIA
sterno|sternō, sternere, strāvī, strātus, spread out, stretch out (27) LL-PAIDEIA
studeo|studeō, studēre, studuī, —, study, busy oneself with (+ dat.) (2) LL-PAIDEIA
studens|studēns, studentis, m./f., student, one studying (16) LL-PAIDEIA
studiosus|studiōsus, -a, -um, adj., eager, keen, full of zeal; studious (6) LL-PAIDEIA
studium|studium, -iī, n., pursuit, study; eagerness, enthusiasm, zeal, spirit (26) LL-PAIDEIA
stultus|stultus, -a, -um, adj., foolish, stupid (20) LL-PAIDEIA
stupeo|stupeō, stupēre, stupuī, —, be astounded, astonished (26) LL-PAIDEIA
suavis|suāvis, suāve, adj., agreeable, charming, pleasant; sweet (30) LL-PAIDEIA
sub|sub, prep. with abl., under; with acc., under, up to (12) LL-PAIDEIA
subito|subitō, adv., suddenly, unexpectedly, at once (16) LL-PAIDEIA
submitto|submittō, submittere, submīsī, submissus, lower, moderate (22) LL-PAIDEIA
subrideo|subrīdeō, subrīdēre, subrīsī, subrīsus, smile (14) LL-PAIDEIA
subsellium|subsellium, -iī, n., bench, low seat (21) LL-PAIDEIA
subter|subter, prep. with acc., beneath, under (24) LL-PAIDEIA
sudo|sūdō, sūdāre, sūdāvī, sūdātus, sweat, perspire (30) LL-PAIDEIA
sudor|sūdor, sūdōris, m., sweat (21) LL-PAIDEIA
sui|suī, pron., himself, herself, itself, themselves (15) LL-PAIDEIA
sum|sum, esse, fuī, futūrus, be, exist (1) LL-PAIDEIA
summus|summus, -a, -um, adj., highest, the top; the best (14) LL-PAIDEIA
sumo|sūmō, sūmere, sūmpsī, sūmptus, take, take up; consume (17) LL-PAIDEIA
super|super, prep. with acc., upon, on; over, above (12) LL-PAIDEIA
supercilium|supercilium, -iī, n., eyebrow (21) LL-PAIDEIA
supero|superō, superāre, superāvī, superātus,  overcome, conquer (23) LL-PAIDEIA
supersum|supersum, superesse, superfuī, superfutūrus, be left over, survive (26) LL-PAIDEIA
surgo|surgō, surgere, surrēxī, surrectus, rise, get up (6) LL-PAIDEIA
suspicio|suspīciō, suspīciōnis, f., suspicion, mistrust (30) LL-PAIDEIA
suspiciosus|suspīciōsus, -a, -um, adj., suspicious (27) LL-PAIDEIA
suspiro|suspīrō, suspīrāre, suspīrāvī, suspīrātus, sigh, utter with a sigh (23) LL-PAIDEIA
sustineo|sustineō, sustinēre, sustinuī, sustentus, support, sustain; hold up (23) LL-PAIDEIA
susurro|susurrō, susurrāre, —, —, mutter, whisper (3) LL-PAIDEIA
suus|suus, -a, -um, adj., his, her, its own; their own (9) LL-PAIDEIA
tabellarius|tabellārius, -iī, m., letter-carrier, courier (19) LL-PAIDEIA
taberna|taberna, -ae, f., tavern, inn; small shop, store; taberna nivāria, ice cream parlor (17) LL-PAIDEIA
tablinum|tablīnum, -ī, n., archive, gallery; in Roman architecture, a room beside the atrium and opposite the main entrance (16) LL-PAIDEIA
taceo|taceō, tacēre, tacuī, tacitus, be silent; fall silent (12) LL-PAIDEIA
talis|tālis, tāle, adj., such, of such kind; tālia, such things (pl.) (20) LL-PAIDEIA
tam|tam, adv., so, so much (as); to such an extent, degree (11) LL-PAIDEIA
tamen|tamen, adv., nevertheless, still (12) LL-PAIDEIA
tamquam|tamquam, conj., as, just as, just as if; as it were (13) LL-PAIDEIA
tandem|tandem, adv., finally, at last; eventually (10) LL-PAIDEIA
tantum|tantum, adv., so much, so far; hardly, only (13) LL-PAIDEIA
tantus|tantus, -a, -um, adj., so great, so much (14) LL-PAIDEIA
tectum|tēctum, -ī, n., roof, ceiling (23) LL-PAIDEIA
tego|tegō, tegere, tēxī, tēctus, cover (27) LL-PAIDEIA
telephonum|tēlephōnum, -ī, n., telephone (22) LL-PAIDEIA
templum|templum, -ī, n., temple, shrine (11) LL-PAIDEIA
tempto|temptō, temptāre, temptāvī, temptātus, attempt, try (17) LL-PAIDEIA
tempus|tempus, temporis, n., time; temporī, on time (10) LL-PAIDEIA
teneo|teneō, tenēre, tenuī, tentus, hold, keep; possess (12) LL-PAIDEIA
tepidus|tepidus, -a, -um, adj., warm, tepid (27) LL-PAIDEIA
tergum|tergum, -ī, n., back, rear (27) LL-PAIDEIA
terra|terra, -ae, f., earth, land; country, region (4) LL-PAIDEIA
terreo|terreō, terrēre, terruī, territus, frighten, scare; terrify (21) LL-PAIDEIA
tertius|tertius, -a, -um, adj., third (1) LL-PAIDEIA
thea|thea, -ae, f., tea (30) LL-PAIDEIA
theatrum|theātrum, -ī, n., theater (19) LL-PAIDEIA
theoria|theōria, -ae, f., theory (22) LL-PAIDEIA
timeo|timeō, timēre, timuī, —, fear, be afraid (17) LL-PAIDEIA
timidus|timidus, -a, -um, adj., timid, cowardly; fearful (10) LL-PAIDEIA
titulus|titulus, -ī, m., title (e.g. of a book) (27) LL-PAIDEIA
tollo|tollō, tollere, sustulī, sublātus, raise, lift up (12) LL-PAIDEIA
tot|tot, adj. indecl., so many (24) LL-PAIDEIA
totus|tōtus, -a, -um, adj., whole, entire, all (11) LL-PAIDEIA
tracto|tractō, tractāre, tractāvī, tractātus, discuss, treat (15) LL-PAIDEIA
trado|trādō, trādere, trādidī, trāditus, hand over, deliver (25) LL-PAIDEIA
tragicus|tragicus, -a, -um, adj., tragic (19) LL-PAIDEIA
tramen|trāmen, trāminis, n., train (26) LL-PAIDEIA
trans|trāns, prep. with. acc., across, over; on the other side (14) LL-PAIDEIA
transeo|trānseō, trānsīre, trānsīvī/trānsiī, trānsitus, go over, cross (21) LL-PAIDEIA
transfero|trānsferō, trānsferre, trānstulī, trānslātus, transport, transfer; translate (22) LL-PAIDEIA
transgredior|trānsgredior, trānsgredī, trānsgressus sum, cross, go across (27) LL-PAIDEIA
tres|trēs, tria, num., three (1) LL-PAIDEIA
triclinium|trīclīnium, -iī, n., dining couch, dining room (20) LL-PAIDEIA
tridens|tridēns, tridentis, m., trident (17) LL-PAIDEIA
triginta|trīgintā, num., thirty (13) LL-PAIDEIA
tristis|trīstis, trīste, adj., sad, sorrowful; gloomy (15) LL-PAIDEIA
triumpho|triumphō, triumphāre, triumphāvī, triumphātus, triumph, celebrate a triumph (24) LL-PAIDEIA
truncus|truncus, -ī, m., trunk; torso (15) LL-PAIDEIA
tu|tū, pron., you (sing.); yourself (2) LL-PAIDEIA
tuba|tuba, -ae, f., trumpet (26) LL-PAIDEIA
tum|tum, adv., then, next; at that time (15) LL-PAIDEIA
tumulus|tumulus, -ī, m., mound, tomb (16) LL-PAIDEIA
tunc|tunc, adv., then, thereupon; at that time (9) LL-PAIDEIA
tunica|tunica, -ae, f., shirt, tunic (25) LL-PAIDEIA
turba|turba, -ae, f., crowd, multitude (22) LL-PAIDEIA
tutus|tūtus, -a, -um, adj., safe, protected (17) LL-PAIDEIA
tuus|tuus, -a, -um, adj., your (sing.) (10) LL-PAIDEIA
ubi|ubi, interr., where; when (4) LL-PAIDEIA
ubi|ubi, adv., where, in what place; when (12) LL-PAIDEIA
ubique|ubīque, adv., everywhere, anywhere (14) LL-PAIDEIA
ullus|ūllus, -a, -um, adj., any (17) LL-PAIDEIA
umbra|umbra, -ae, f., shadow; shade, ghost (25) LL-PAIDEIA
umerus|umerus, -ī, m., upper arm, shoulder (27) LL-PAIDEIA
umquam|umquam, adv., ever, at any time (16) LL-PAIDEIA
unde|unde, adv., from where, whence (14) LL-PAIDEIA
universitas|ūniversitās, ūniversitātis, f., university (2) LL-PAIDEIA
unus|ūnus, -a, -um, num., one, alone, a single (1) LL-PAIDEIA
urbs|urbs, urbis, f., city (4) LL-PAIDEIA
usque|usque, adv., until, up to; often with ad (20) LL-PAIDEIA
usus|ūsus, -ūs, m., use, usage (22) LL-PAIDEIA
ut|ut, conj., like, as; just as (4) LL-PAIDEIA
uter|uter, utra, utrum, adj., which (of two) (17) LL-PAIDEIA
uterque|uterque, utraque, utrumque, pron., each (of two) (22) LL-PAIDEIA
utique|utique, adv., certainly, by all means; in any case (29) LL-PAIDEIA
utor|ūtor, utī, ūsus sum, use, make use of (+ abl.) (19) LL-PAIDEIA
utrum|utrum, conj., whether (introducing an indirect question); utrum… an, whether…or (30) LL-PAIDEIA
uva|ūva, -ae, f., grape (14) LL-PAIDEIA
uxor|uxor, uxōris, f., wife (9) LL-PAIDEIA
vacuus|vacuus, -a, -um, adj., empty, vacant (14) LL-PAIDEIA
vado|vādō, vādere, vāsī, —, go, advance (27) LL-PAIDEIA
vae|vae, interj., woe, alas (27) LL-PAIDEIA
vagor|vāgor, vagārī, vagātus sum, wander, roam (25) LL-PAIDEIA
valde|valdē, adv., greatly, strongly (6) LL-PAIDEIA
valedico|valedīcō, valedīcere, valedīxī, valedictus, say goodbye (29) LL-PAIDEIA
valeo|valeō, valēre, valuī, valitus, be strong, healthy; valē, goodbye, farewell (10) LL-PAIDEIA
varius|vārius, -a, -um, adj., different, various, diverse (19) LL-PAIDEIA
vates|vātēs, vātis, m., prophet, seer, poet (21) LL-PAIDEIA
vehemens|vehemēns, gen. vehementis, adj., severe, vigorous (16) LL-PAIDEIA
vehementer|vehementer, adv., strongly, vigorously (28) LL-PAIDEIA
vel|vel, conj., or; vel…vel, either…or (11) LL-PAIDEIA
venatio|vēnātiō, vēnātiōnis, f., hunting, the hunt (24) LL-PAIDEIA
vendo|vēndō, vēndere, vēndidī, vēnditus, sell (13) LL-PAIDEIA
venenum|venēnum, -ī, n., poison (15) LL-PAIDEIA
veneratio|venerātiō, venerātiōnis, f., reverence, veneration (21) LL-PAIDEIA
venio|veniō, venīre, vēnī, ventus, come (13) LL-PAIDEIA
venustus|venustus, -a, -um, adj., attractive, charming (29) LL-PAIDEIA
verbum|verbum, -ī, n., word (1) LL-PAIDEIA
vero|vērō, adv., yes; truly, in truth; certainly (13) LL-PAIDEIA
verro|verrō, verrere, verrī, versus, sweep, sweep clean (21) LL-PAIDEIA
versor|versor, versārī, versātus sum, dwell, live in (18) LL-PAIDEIA
versus|versus, -ūs, m., verse, line of poetry (17) LL-PAIDEIA
verto|vertō, vertere, vertī, versus, turn, turn around (27) LL-PAIDEIA
verus|vērus, -a, -um, adj., true, real, genuine; rē vērā, in truth, really (13) LL-PAIDEIA
vesper|vesper, vesperis, m., evening (21) LL-PAIDEIA
vesperi|vesperī, adv., in the evening (21) LL-PAIDEIA
Vesta|Vesta, -ae, f., goddess of the hearth and the household (17) LL-PAIDEIA
Vestalis|Vestālis, Vestāle, adj., Vestal, of Vesta (19) LL-PAIDEIA
vester|vester, vestra, vestrum, adj., your (pl.) (11) LL-PAIDEIA
vestiarium|vestiārium, -iī, n., wardrobe, cupboard for storing clothes and possessions (27) LL-PAIDEIA
vestigium|vestīgium, -iī, n., trace, remnant, vestige; imprint (23) LL-PAIDEIA
vestimentum|vestīmentum, -ī, n., garment, clothes (25) LL-PAIDEIA
vestio|vestiō, vestīre, vestīvī, vestītus, clothe, dress (25) LL-PAIDEIA
vestis|vestis, vestis, f., garment; clothing, piece of clothing (25) LL-PAIDEIA
vetus|vetus, veteris, superl. veterrimus, adj., old, aged, ancient (23) LL-PAIDEIA
vexo|vexō, vexāre, vexāvī, vexātus, annoy, disturb, irritate (9) LL-PAIDEIA
via|via, -ae, f., street, road, way (5) LL-PAIDEIA
viator|viātor, viātōris, m., traveler, pedestrian (25) LL-PAIDEIA
vicinus|vīcīnus, -a, -um, adj., next to, neighboring (+ dat.) (29) LL-PAIDEIA
vicis|vicis, vicis, f., turn, change, succession (29) LL-PAIDEIA
victima|victima, -ae, f., victim, animal for sacrifice (21) LL-PAIDEIA
victor|victor, victōris, m., victor, conqueror (29) LL-PAIDEIA
victoria|victōria, -ae, f., victory (24) LL-PAIDEIA
vicus|vīcus, -ī, m., quarter, neighborhood (16) LL-PAIDEIA
video|videō, vidēre, vīdī, vīsus, see, look at; pass. be seen, seem (4) LL-PAIDEIA
vigil|vigil, vigilis, m., sentry, guard; fireman (19) LL-PAIDEIA
vigilo|vigilō, vigilāre, vigilāvī, vigilātus, stay awake, be awake; watch, be vigilant (21) LL-PAIDEIA
viginti|viginti, num., twenty (2) LL-PAIDEIA
villa|vīlla, -ae, f., villa, country estate, farm (14) LL-PAIDEIA
vinco|vincō, vincere, vīcī, victus, conquer, defeat, overcome; win (20) LL-PAIDEIA
vinculum|vinculum, -ī, n., chain, bond (22) LL-PAIDEIA
vindico|vindicō, vindicāre, vindicāvī, vindicātus, punish, avenge (27) LL-PAIDEIA
vinum|vīnum, -ī, n., wine (13) LL-PAIDEIA
vir|vir, virī, m., man, husband (1) LL-PAIDEIA
virga|virga, -ae, f., twig, sprout, stalk (27) LL-PAIDEIA
virgo|virgō, virginis, f., virgin (19) LL-PAIDEIA
viridis|viridis, viride, adj., fresh, green; blooming (15) LL-PAIDEIA
virtus|virtūs, virtūtis, f., strength; bravery, courage; virtue (17) LL-PAIDEIA
vis|vīs, vīs, f., force, might (19) LL-PAIDEIA
visito|vīsitō, vīsitāre, vīsitāvī, vīsitātus, visit, call upon (14) LL-PAIDEIA
vita|vīta, -ae, f., life, lifetime; lifestyle (15) LL-PAIDEIA
vito|vītō, vītāre, vītāvī, vītātus, avoid, evade; stay away from (30) LL-PAIDEIA
vivax|vīvāx, gen. vīvācis, adj., long-lived; lively, energetic (18) LL-PAIDEIA
vivo|vīvō, vīvere, vīxī, victus, be alive, live (9) LL-PAIDEIA
vivus|vīvus, -a, -um, adj., alive, living; vīvā vōce, orally, out loud (21) LL-PAIDEIA
vix|vix, adv., hardly, scarcely; barely, only just (17) LL-PAIDEIA
voco|vocō, vocāre, vocāvī, vocātus, call; name (15) LL-PAIDEIA
volens|volēns, gen. volentis, adj., willing (25) LL-PAIDEIA
volo|volō, velle, voluī, —, wish, want (12) LL-PAIDEIA
volo|volō, volāre, volāvī, volātus, fly (8) LL-PAIDEIA
volucer|volucer, volucris, volucre, adj., winged; flying, capable of flight (18) LL-PAIDEIA
volumen|volūmen, volūminis, n., book, volume (22) LL-PAIDEIA
voluptas|voluptās, voluptātis, f., pleasure, delight; enjoyment (24) LL-PAIDEIA
volvo|volvō, volvere, volvī, volūtus, roll, revolve (23) LL-PAIDEIA
vos|vōs, pron., you (pl.) (4) LL-PAIDEIA
vox|vōx, vōcis, f., voice; expression, word (18) LL-PAIDEIA
vulnero|vulnerō, vulnerāre, vulnerāvī, vulnerātus, wound, injure; do harm to (24) LL-PAIDEIA
vulnus|vulnus, vulneris, n., wound, injury (17) LL-PAIDEIA
vultus|vultus, -ūs, m., face, facial expression (25) LL-PAIDEIA
xylon|xylon, -ī, n., cotton (plant) (28) LL-PAIDEIA